ASV1	GTTGGTAAATCTCGTGCCAGCCACCGCGGTTATACGAGTGACCCTTATTAATATTTTCCCGGCGTAAAGAGTGGTTTAAGAAAACCTTAAACAACTAAAGTTAAGACCTCATCAAGCCGTTATACGCTCTTATGAGAGGAATTATCAACAACGAAAGTGACTTTATAATATTAGAGACCTTGATGCCACGACAGTTGGGCCCCAAACTAGGATTAGATACCCCACTATG
ASV2	GTTGGTAAATCTCGTGCCAGCCACCGCGGTCATACGATTAACCCAAGCTAACAGGAGTACGGCGTAAAACGTGTTAAAGCACCATACCAAATAGGGTTAAATTCTAACTAAGCTGTAAAAAGCCATGATTAAAATAAAAATAAATGACGAAAGTGACCCTACAATAGCCGACGCACTATAGCTAAGACCCAAACTAGGATTAGATACCCCACTATG
ASV3	GTTGGTAAATCTCGTGCCAGCCACCGCGGTCATACGATTAACCCAAATTAATAGATCCACGGCGTAAAGAGTGTTTAAGAAAAAAAAATCACAATAGAGTTAAATTATAACTAAGCTGTAAAAAGCCCTAGTTAAAATAAAATAACCCACGAAAGTGACTCTAATAATCCTGACACACGATAGCTAGGACCCAAACTAGGATTAGATACCCCACTATG
ASV4	GTTGGTAAATCTCGTGCCAGCCACCGCGGTTATACGAGAGACCCTAGTTGATATACTCGGCGTAAAGAGTGGTTATGGAAAACAAGCACTAAAGCCAAAGAGCCCTCAGGCCGTTATACGCACCCGGGGCCTCGAACCACTATCACGAAAGTAGCTTTACCCTCGCCCACCAGAACCCACGAGAGCTGGGACACAAACTAGGATTAGATACCCCACTATG
ASV5	GTTGGTAAATCTCGTGCCAGCCACCGCGGTCATACGATTAACCCAAACTAATAGGCCTACGGCGTAAAGCGTGTTCAAGATACTTTAACACTAAAGTTAAAACTTAACTAAGCCGTAAAAAGCTACAGTTATCATAAAATAAACCACGAAAGTGACTTTATAATAATCTGACTACACGATAGCTAAGACCCAAACTAGGATTAGATACCCCACTATG
ASV6	GTTGGTAAATCTCGTGCCAGCCACCGCGGTTATACGAGTGACCCTTATTAATATTTTCCCGGCGTAAAGAGTGGTTTAAGAAAACCTTAAACAACTAAAGTTAAGACCTCATCAAGCTGTTATACGCTCTTATGAGAGGAATTATCAACAACGAAAGTGACTTTATAATATTAGAGACCTTGATGCCACGACAGTTGGGCCCCAAACTAGGATTAGATACCCCACTATG
ASV7	GTTGGTAAATCTCGTGCCAGCCACCGCGGTCATACGATTAACCCAAATTAATAGATCCACGGCGTAAAGAGTGTTTAAGAAAAAAAACCACAATAGAGTTAAATTATAACTAAGCTGTAAAAAGCCCTAGTTAAAATAAAATAACCCACGAAAGTGACTCTAATAATCCTGACACACGATAGCTAGGACCCAAACTAGGATTAGATACCCCACTATG
ASV8	GTTGGTAAATCTCGTGCCAGCCACCGCGGTCATACGATTGACCCAAGCTAACAGGAGTACGGCGTAAAGCGTGTTAAAGCATCATACTAAATAGAGTTAAATTTTAATTAAACTGTAAAAAGCCATAATTATAACAAAAATAAATGACGAAAGTAACCCTACAATAGCTGATACACCATAGCTAAGACCCAAACTAGGATTAGATACCCCACTATG
ASV9	GTTGGTAAATCTCGTGCCAGCCACCGCGGTCATACGATTAACCCAAACTAATAGGCCTACGGCGTAAAGCGTGTTCAAGATATTTTTACACTAAAGTTAAAACTTAACTAAGCCGTAAAAAGCTACAGTTATCATAAAATAAACCACGAAAGTGACTTTATAATAATCTGACTACACGATAGCTAAGACCCAAACTAGGATTAGATACCCCACTATG
ASV10	GTTGGTAAATCTCGTGCCAGCCACCGCGGTCATACGATTAACCCAAATTAATAGGCATACGGCGTAAAACGTGTTAAAGCACTACATTAAATAAAGTTAAATTTCAATTAAACTGTAAAAAGTCATAATTGCAATGAAAATAGATAACGAAAGTAACTTTACAGCCACTGAAACACGATAGCTAAGACCCAAACTAGGATTAGATACCCCACTATG
ASV11	GTTGGTAAATCTCGTGCCAGCCACCGCGGTCATACGATTAACCCAAACTAATAGGCCTACGGCGTAAAGCGTGTTCAAGATACTTTTACACTAAAGTTAAAACTTAACTAAGCCGTAAAAAGCTACAGTTATCATAAAATAAACCACGAAAGTGACTTTATAATAATCTGACTACACGATAGCTAAGACCCAAACTAGGATTAGATACCCCACTATG
ASV12	AGCTCCAATAGTGTATATTAAAGTTGTTGCAGTTAAAAAGCTCGTAGTTGGATTTCAAGAAACGCATCTGGGTCACCAGTATGCTTTCTACCAGTCTCTGACTGTTACTGTGAGAAAATTAGAGTGTTTCAAGCAGGCAATTGCAGGAATACATTAGCATGGAATAACGAATGGGTCTACAATTTGGTTGATTGTAGATTGCGATTAATAGGGACAGTTGGGGGCATTAGTATTTAATTGTCAGAGGTGAAATTCTTGGATTAGTTAAAGACTAACGTATGCGAAAGCATTTGCCAAGGATGTTT
ASV13	GTTGGTAAATCTCGTGCCAGCCACCGCGGTCACACGATTAACCCAAGTCAATAGAAGCCGGCGTAAAGAGTGTTTTAGATCACCCCCTCCCCAATAAAGCTAAAACTCACCTGAGTTGTAAAAAACTCCAGTTGACACAAAATAGACTACGAAAGTGGCTTTAACATATCTGAACACACAATAGCTAAGACCCAAACTAGGATTAGATACCCCACTATG
ASV14	AGCTCCAATAGCGTATATTAAAGTTGTTGTGGTTAAAAAGCTCGTAGTTGGATCTCGGCGGACTGAGGGCGGTTTGCTTGCTAGTATTACTGCCCTATAGTCCGTAGTTTTGCCAGAGGTTTCGGGGTGCTCTTAATCGAGTGTCCCGGGATAGGGACAGTCGGGGGCATTTGTATTCAAACGACAGAGGTGAAATTCTTGGACCGTTTGAAGACAAACTACTGCGAAAGCATTTGCCAAGAATGTTTTCA
ASV15	GTTGGTAAATCTCGTGCCAGCCACCGCGGTTATACGAGTAACTCACATTAATACTTCACGGCGTAAAGGGTGATTAAAAGTTTCTAAAAAGTACTAGAGTTATAACCTTATAAAGCTGTCATACGCACCTATAAAAGGAACAATACACTGACGAAAGTAACTTTAACAATTTAGAGCTTTTGACCTCACGACAGTTAAGACACAAACTAGGATTAGATACCCCACTATG
ASV16	GTTGGTAAATCTCGTGCCAGCCACCGCGGCCATACGATTAACCCAAACTAACGGGCCCACGGCGTAAAGCGTGTAAAAGATCTACCAACACTAAAGTTAAAATTTAACCAAGCCGTAAAAAGCTACCGTTAATACAAAATACACTACGAAAGTGACTTTAATAATTCTGATTGCACGATAGCTAAGACCCAAACTAGGATTAGATACCCCACTATG
ASV17	GTTGGTAAATCTCGTGCCAGCCACCGCGGTCATACGATTAACCCAAACTAATAGGCCCTCGGCGTAAAGCGTGTTAAAGATCAACCCACACTAAAGCTAAAACCTAACCAAGCCGTAAAAAGCTACCGTTAACATAAAATAGACCACGAAAGTGACTTTACTAATTCTGACTGCACGATAGCTAAGATCCAAACTAGGATTAGATACCCCACTATG
ASV18	GTTGGTAAATCTCGTGCCAGCCACCGCGGTTATACGAGCGGCCCAAGTTGATAAAAATCGGCGTAAAGCGTGGTTAAAAAAATGTTTAAACTAGAGCCGAATAGCCTCAAAGCAGTTATACGCACTCGAGGCCACGAAGTACAATTACAAAAGTAGCTCTACCCCACTTTGACTCCACGAAAACCATAAAACAAACTAGGATTAGATACCCCACTATG
ASV19	GTTGGTAAATCTCGTGCCAGCCACCGCGGTTATACGAGAGGCCCAAGTTGACAGACAACGGCGTAAAGAGTGGTTAGGGAACAAATTAAAATAGAGCCAAACGCTTTCACAGCTGTTATACGCACCCGAGAGTATGAAACCCAATCACGAAAGTAACTCTACTAACCCTGAGCCCACGAAAGCTAAGAAACAAACTAGGATTAGATACCCCACTATG
ASV20	ACGTTTTTGGCCTGAACGTTCTAATTGATATTTCATATCTCTGACAAGATTTCTAAATGCAGTTCTAAACAAATCTGCAAGCATTTGTCCTGCAAATTTGATTACTTTATTTCCATAGTGATCTTTGTCATCAGGGGTGATCCAACCAAGTTTTAATTCTAATAATTTACAAGCTGCTTCACCTAAGAATTGTGCTTTTTCTTTTCTATTTTCTTGCTGTTTACCTAAATGAGGTAATAGACC
ASV21	GTTGGTAAATCTCGTGCCAGCCACCGCGGTCATACGATTAACCCAAATTAATAGATCCACGGCGTAAAGAGTGTTTAAGAAAAAAAATCACAATAGAGTTAAATTATAACTAAGCTGTAAAAAGCCCTAGTTAAAATAAAATAACCCACGAAAGTGACTCTAATAATCCTGACACACGATAGCTAGGACCCAAACTAGGATTAGATACCCCACTATG
ASV22	GTTGGTAAATCTCGTGCCAGCCACCGCGGTCATACGATTGACCCGAATTAATAGACACCCGGCGTAAAGAGTGTCAAGGAACAATATAAAAATAAAGTCAAACCTTAATTAAGCTGTAAAAAGCCATAATTAAAATTAAGTTAAACTACGAAAGTAACTTTACCATAAACTGAGTACACGACAACTAAGACCCAAACTAGGATTAGATACCCCACTATG
ASV23	AGCTCCAATAGCGTATATTAAAGTTGTTGCGGTTAAAAAGCTCATAGTTGGATCTCAGCTCCAGACCGACGGTACGCCACCCAGCGTCTACTGTCTGCTTCCAAACTTTGAAAAAATGAGGGTGCTCAGAGCAGGCCAAGGCACCTGAAAACTTGTGCATGGAATAATGGAATAGGATGGTACTAGGTTTGATTTGTTGGTTTATGAGCCCGAGGTAATGATTAAGAGAAACAGACGGGGGCATTTGTTTTGCGACGTTAGGGGTGAAAGTCTTGGATTGTCGAAGATGAACGACTGCGAAAGCATTTGCCAAGAGTGTTT
ASV24	GTTGGTAAATCTCGTGCCAGCCACCGCGGCCATACGATTAACCCAAGTTAATAGGCACACGGCGTAAAGCGTGTTTAAGCACTATACCAAATAAAGTTAAATTTTAATTAAGCTGTAGAAAGCCATAATCAAAACGAAAATAGATAACGAAAGTAACTTTACAACCGCTGAAACACGATAGCTAAGATCCAAACTAGGATTAGATACCCCACTATG
ASV25	AGCTCCAATAGCGTATATTAAAGTTGTTGCAGTTAAAAAGCTCGTAGTTGGATCTCAGATTGTGGCTTCATTGGGTGCGTTCGAGAATTGGAAGTTTTACTTTGAAAAAATTAGAGTGTTCAAGGCAGGCGATTCGCCTGAATAATGGTGCATGGAATAATGGAATAGGACCTCGGTTCTATTTTGTTGGTTTTCGGAACTCGAGGTAATGATTAAGAGGGACAGACGGGGGCATTCGTATTACGGTGTTAGAGGTGAAATTCTTGGATCGCCGTAAGACGAACTACTGCGAAAGCATTTGCCAAGAATGTTT
ASV26	AGCTCCAATAGCGTATATTAAAGTTGTTGCAGTTAAAAAGCTCGTAGTTGGATTTCGGAGTGGGCCAGTTGGTCCGCCGCAAGGTGTGTTACTGACAAAATTAGAGTGTTCAAAGCAGGCTATTGCTTGAATACATGAGCATGGAATAATGGAATAGGACTTTGGTCCCATTTTGTTGGTTTCTAGGGCCGAAGTAATGATTAAGAGGGACAATTGGGGGCATCCGTATTTCGTTGTCAGAGGTGAAATTCTTGGATTTACGAAAGACGAACAACTGCGAAAGCACTTGCCAAGAGTGTTT
ASV27	GTTGGTAAATCTCGTGCCAGCCACCGCGGTTATACGAGAGGCCCTAGTTGATAACTACCGGCGTAAAGAGTGGTTATGGAAAATATTTAATAAAGCCGAACACCCCCTCAGCCGTCATACGCACCTGGGAGCACGAAGACCTACCGCGAAAGCAGCTTTAATTATGCCTGACCCCACGACAGCTAAGAAACAAACTAGGATTAGATACCCCACTATG
ASV28	GTTGGTAAATCTCGTGCCAGCCACCGCGGTTATACGAGAGGCCCAAGTTGAAAGACATCGGCGTAAAGAGTGGTTAAGTTAAAATTGTACTAAAGCCGAACATCCTCCAGGCTGTTATACGCATCCGAAGATAAGAAGTTCAACCACGAAGGTAGCTTTATTTAGTCTGAACCCACGAAAGCTACGGCACAAACTAGGATTAGATACCCCACTATG
ASV29	GTTGGTAAATCTCGTGCCAGCCACCGCGGTCATACGATTAACCCAAGCTAACAGGAACACGGCGTAAAACGTGTTAAAGCACTACATCAAATAGAGTTAAATTCTAATTAAACTGTAAAAAGCCATAATTACAACAAAAATAAGTGACGAAAGTAACCCTACAGCAGCTGACACACTATAGCTAAGGCCCAAACTAGGATTAGATACCCCACTATG
ASV30	AGCTCCAATAGCGTATATTAAAGTTGTTGTGGTTAAAAAGCTCGTAGTTGGATCTCAACAGCCTTGAAGCGGTTAACTTTGTAGTTTTACTGCATCCTATTCTATTATTCCATGCACGAATATTCAGGCATTTTAGCCTGCTTTGAGCACTCTAATTTTTTCAAAGTAAACCTGCTGGCATCCAGAGACACTCGA
ASV31	AGCTCCAATAGCGTATATTAAAGTTGTTGTGGTTAAAAAGCTCATAGTTGGATCTCAGCTCCAGACCGACGGTACGCCACCCAGCGTCTACTGTCTGCTTCCAAACTTTGAAAAAATGAGGGTGCTCAGAGCAGGCCAAGGCACCTGAAAACTTGTGCATGGAATAATGGAATAAGATGGTACTAGGTTTGATTTGTTGGTTTATGAGCCTGAGTTAATGATTAAGAGAAACAGACGGGGGCATTTGTTTTGCGACGTTAGGGGTGAAAGTCTTGGATTGTCGAAGGTGAACGACTGCGAAAGCATTTGCCAAGAGTGTTT
ASV32	GTTGGTAAATCTCGTGCCAGCCACCGCGGTTATACGAGAGGCCCAAGCTGATAGACCCCGGCGTAAAGAGTGGTTAAGGTAAACTTAAAACTAAAGCCGAACACCCTCACAGCTGTTATACGCACCCGAGAGTAAGAAGCCCAACTACGAAAGTGGCTTTACAACCCCTGAACCCACGAAAGCTATGACACAAACTAGGATTAGATACCCCACTATG
ASV33	GTTGGTAAATCTCGTGCCAGCCACCGCGGTCATACGATTAACCCAAGCCAACAGGAATACGGCGTAAAACGTGTTAAAGCACCACATCAAATAGGGTTAAATTTTAATTAAGCTGTAAAAAGCCATGATTAAAATAAAAATAAATGACGAAAGTAACCCTACAACAGCCGATGCACTATAGCTAAGACCCAAACTAGGATTAGATACCCCACTATG
ASV34	GTTGGTAAATCTCGTGCCAGCCACCGCGGTCATACAAGAAACCCAAATCAATAGCTACCCGGCGTAAAGAGTGGCCACATGTTATCTGCACCAGCTAAGATTAAAATGCAACCAAGCTGTCATAAGCCTAAGATCCACCTAAACCCAACCCAAATCCATCTTAGCCTCAACGATTAATTTTAACCCACGAAAGCTAGGACCCAAACTAGGATTAGATACCCCACTATG
ASV35	GTTGGTAAATCTCGTGCCAGCCACCGCGGTTATACGAGAGGCCCAAGTTGACAGACATCGGCGTAAAGAGTGGTTAAGTTAAAATTCACACTAAAGCCGAACGTCCTCCAGGCTGTTATACGCACCCGAAGATAAGAAGTTCAATCACGAAAGTGGCTTTATTTAATCTGAACCCACGAAAGCTACGGCACAAACTAGGATTAGATACCCCACTATG
ASV36	GTTGGTAAATCTCGTGCCAGCCACCGCGGTCATACGATTGACCCAAATTAATAGACACCCGGCGTAAAGAGTGTCAAAGAACGATATAAAAATAAAGTTAAGCCTTAATTAAGCTGTAAAAAGTCATAATTAAAACTAAGTTAAACTACGAAAGTAACTTTACCATAAACTGAGTACACGACAACTAAGATCCAAACTAGGATTAGATACCCCACTATG
ASV37	AGCTCCAATAGCGTATATTAAAGTTGTTGCAGTTAAAAAGCTCGTAGTTGGATTTCGGAGTGGGCCAGTTGGTCCGCCGCAAGGTGTGTTACTGACTGGTTTGCTCTTCTTCGCAAAGACTGCGTGTGCTCTTGAGTGAGTGTGCGTAGGATTTACGACGTTTACTTTGAAAAAATTAGAGTGTTCAAAGCAGGCTATTGCTTGAATACATGAGCATGGAATAATGGAATAGGACTTTGGTCCCATTTTGTTGGTTTCTAGGGCCGAATTGGATTTACGAAAGACGAACAACTGCGAAAGCACTTGCCAAGAGTGTTT
ASV38	AGCTCCAATAGCATATATTAAAGTTGTTGTGGTTAAAAAGCTCATAGTTGGATCTCAGCTCCAGACCGACGGTACGCCACCCAGCGTCTACTGTCTGCTTCCAAACTTTGAAAAAATGAGGGTGCTCAGAGCAGGCCAAGGCACCTGAAAACTTGTGCATGGAATAATGGAATAGGATGGTACTCGGTTTGATTTGTTGGTTTAAGAGCCCGAGGTAATGATTAAGAGAAACAGACGGGGGCATTTGTTTTGCGACGTTAGAGGTGAAAGTCTTGGATTGTCGAAGATGAACGACTGCGAAAGCATTTGCCAAGAGTGTTT
ASV39	GTTGGTAAATCTCGTGCCAGCCACCGCGGTTATACGAGAGGCCCAAGTTGAAAGACATCGGCGTAAAGAGTGGTTAAGTTAAAATTTATACTAAAGCCGAACATCCTCAAGGCTGTTATACGCACCCGAAGATAAGAAGTTCAACCACGAAAGTGGCTTTATTTAAGCTGAACCCACGAAAGCTACGGCACAAACTAGGATTAGATACCCCACTATG
ASV40	AGCTCCAATAGTGTATATTAAAGTTGTTGCAGTTAAAAAGCTCGTAGTTGGATTTCAAGAAACGCATCTGGGTCACCAGTATGCTTTCTACCAGTCTTTGACTGTTACTGTGAGAAAATTAGAGTGTTTCAAGCAGGCAATTGCAGGAATACATTAGCATGGAATAACGAATGGGTCTACAATTTGGTTGATTGTAGATTGCGATTAATAGGGACAGTTGGGGGCATTAGTATTTAATTGTCAGAGGTGAAATTCTTGGATTAGTTAAAGACTAACGTATGCGAAAGCATTTGCCAAGGATGTTT
ASV41	AGCTCCAATAGCGTATATTAAAGTTGTTGTGGTTAAAAAGCTCGTAGTTGGCTATTACGCCTGAATATTCGTGCATGGAATAATAGAATAGGAAGTCGTTTCTATTTTGTTGGTTTTCGGAAATCGACTTAATGATTAATAGGGACAGTCGGGGGCATTTGTATTCAAACGACAGAGGTGAAATTCTTGGACCGTTTGAAGACAAACTACTGCGAAAGCATTTGCCAAGAATGTTT
ASV42	GTTGGTAAATCTCGTGCCAGCCACCGCGGTTATACGAGAGGCCCAAGTAGATAGACACCGGCGTAAAGAGTGGTTAAGTTAAAACTCACACTAAAGCCAAACATCTTCAAGACTGTTATACGTAACCGAAGACCGGAAGTTCAACCACGAAAGTGGCTTTATTTGATCTGAACCCACGAAAGCTACGGCACAAACTAGGATTAGATACCCCACTATG
ASV43	GTTGGTAAATCTCGTGCCAGCCACCGCGGTCATACGATTAGCCCAAACTAATAGACCCACGGCGTAAAGCGTGTTACAGAGAAAAAAATATACTAAAGTTAAATTTTAACTAGGCCGTAGAAAGCTAGAGTTAACATAAAAATACAGCACGAAAGTAACTTTAACACCTCCGACTACACGACAGCTAAGACCCAAACTAGGATTAGATACCCCACTATG
ASV44	AGCTCCAATAGCGTATATTAAAGTTGTTGTGGTTAAAAAGCTCGTAGTTGGATCATCGAGTGTCCCGGGATGCTGGCAGGTTTACTTTGAAAAAATTAGAGTGCTCAAAGCAGGCTATTACGCCTGAATATTCGTGCATGGAATAATAGAATAGGAAGTCGTTTCTATTTTGTTGGTTTTCGGAAATCGACTTAATGATTAATAGGGACAGTCGGGGGCATTTGTATTCAAACGACAGAGGTGAAATTCTTGGACCGTTTGAAGACAAACTACTGCGAAAGCATTTGCCAAGAATGTTT
ASV45	GTTGGTAAATCTCGTGCCAGCCACCGCGGTTATACGAGAGGCCCTAGTTGATAACTACCGGCGTAAAGAGTGGTTACGGAAAAATATTTAATAAAGCCGAACACCCCCTCAGCCGTCATACGCACCTGGGGGCACGAAGATCTACTACGAAAGCAGCTTTAATTATACCTGAACCCACGACAGCTACGACACAAACTAGGATTAGATACCCCACTATG
ASV46	GTTGGTAAATCTCGTGCCAGCCACCGCGGTTATACGAGAGACCCTAGTTGATTGAAGCGGCGTAAAGAGTGGTTATGGAGTTTTCCCCTTTAAAGCAGAAAACCTCTCAAACTGTTATACGCACCCAGAGGTTGAAATCCCTCACACGAAAGTGACTTTATATTCGCCTACCAGAACCCACGAAAGCTGGGACACAAACTAGGATTAGATACCCCACTATG
ASV47	GTTGGTAAATCTCGTGCCAGCCACCGCGGTTATACGAGAGGCCCAAGTTGACAAACAACGGCGTAAAGAGTGGTTAGGGGATTTAATAAACTAGAGCCGAACGCTTTCAAAGCTGTTATACGCACCCGAAAGTATGAAACCCAATTACGAAAGTAGCTCTACCTATCCTGAACCCACGAAAGCTAAGGAACAAACTAGGATTAGATACCCCACTATG
ASV48	CTCGGTCCATTGTGGCACCCGCACGAGGCTGAGGTAGGCGCCCCCCAAGCCGGCACAGGCACCGCCGAACATGATCGCCAAAAGCCGGATACGGATTACCTTATAGCCCAGGGCATGGGCGGCATCATGGTTTTCGCCCACGCCACGTAAAATCAGCCCGGCTCGGCTGTATTTCAGCACAGCCCAGACCGCAAAGACCAGTGCAAGGCTGACATAGACCATCGGATCATGTGAAAACACGATCGGGCCCAAAACTGGAATATCGGACAGACCGGGGATATCAAGCGCCGGCAATGTTGGCGATTTCATCCCTTCATAGGGT
ASV49	AGCTCCAATAGCGTATATTAAAGTTGTTGTGGTTAAAAAGCTCATAGTTGGATCTCAGCTCCAGACCGACGGTACGCCACCCAGCGTCTACTGTCTGCTTCCAAACTTTGAAAACATGAGGGTGCTCAGAGCAGGCCAAGGCACCTGAAAACTTGTGCATGGAATAATGGAATAGGATGGTACTAGGTTTGATTTGTTGGTTTATGAGCCCGAGGTAATGATTAAGAGAAACAGACAGGGGCATTTGTTTTGCGACGTTAGGGGTGAAAGTCTTGGATTGTCGAAGATGAACGACTGCGAAAGCATTTGCCAAGAGTGTTT
ASV50	AGCTCCAATAGCGTATATTAAAGTTGTGTTACTGACTGGTTTGCTCTTCTTCGCAAAGACTGCGTGTGCTCTTGAGTGAGTGTGCGTAGGATTTACGACGTTTACTTTGAAAAAATTAGAGTGTTCAAAGCAGGCTATTGCTTGAATACATGAGCATGGAATAATGGAATAGGACTTTGGTCCCATTTTGTTGGTTTCTAGGGCCGAAGTAATGATTAAGAGGGACAATTGGGGGCATCCGTATTTCGTTGTCAGAGGTGAAATTCTTGGATTTACGAAAGACGAACAACTGCGAAAGCACTTGCCAAGAGTGTTT
ASV51	GTTGGTAAATCTCGTGCCAGCCACCGCGGTCACACAAGAGACCCAAATTAACCGTATACGGCGTAAAGAGTGGCACTATGATATCACAGTGACTAGGATTAAGATGCAACTAAGCTGTCATAAGCCCAAGGTGTACTTAAGATCACCTTTAAGATGATCCTAGTACTTCTGATTGATTTAACCCCACGAAAGCTAGGACACAAACTAGGATTAGATACCCCACTATG
ASV52	GTTGGTAAATCTCGTGCCAGCCACCGCGGTCATACGATTAACCCAAACTAACGGGCTCACGGCGTAAAGCGTGTAAAAGATCTACCTACACTAAAGTTAAAATTTAACCAAGCCGTAAAAAGCTGCCGTTAATACAAAATATACTACGAAAGTGACTTTAATAATTCTGATTACACGATAGCTAAGACCCAAACTAGGATTAGATACCCCACTATG
ASV53	GTTGGTAAATCTCGTGCCAGCCACCGCGGCTATACGAGAGACCCAAGTTGATACCATTCGGCGTAAAGAGTGGTTATGGAAAATAAAGACTAAAGCCGCACACCTTCAAAGCTGTTATACGCATCCGAAGGCTAGAAGATCAACCACGAAGGTAGCTTTACAACCCCTGACCCCACGAAAGCTCTGGCACAAACTAGGATTAGATACCCCACTATG
ASV54	AGCTCCAATAGCGTATATTAAAGTTGTTGCGGTTAAAAAGCTCGTAGTTGGATCTCGGCAAGTAGAGGGCGGTATGCTTCGGAAATCGACTTAATGATTAATAGGGACAGTCGGGGGCATTTGTATTCAAACGACAGAGGTGAAATTCTTGGACCGTTTGAAGACAAACTACTGCGAAAGCATTTGCCAAGAATGTTTTCA
ASV55	AGCTCCAATAGCGTATATTAAAGTTGTTGCGGTTAAAAAGCTCGTAGTTGGATCTCAGTTCCGGACCGACGGAATTGATTAACAGGAACAGACGGGGGCATCCGTATTGCGACGTTAGAGGTGAAATTCTTGGACCGTCGCAAGACGAACTACTGCGAAAGCATTTGCCAAGAATGTCTTCA
ASV56	GTTGGTAAATCTCGTGCCAGCCACCGCGGTTATACGAGAGGCCCTAGTTGATTCACTCGGCGTAAAGAGTGGTTATGGAGAATAAAATACTAAAGCCGAAGGCCCCTTAGGCCGTCATACGCACCTAGAGGCTCGAATTATAGACACGAAAGTAGCTTTACCCCTTCCCACCAGAACCCACGACAGCTGGGACACAAACTAGGATTAGATACCCCACTATG
ASV57	AGCTCCAATAGCGTATATTAAAGTTGTTGCAGTTAAAAAGCTCGTAGTTGGATTTCGGAGTGGGCCAGTTGGTCCGCCGCAAGGTGTGTTACTGACTGGTTTGCTCTTCTTCGCAAAGACTGCGTGTGCTCTTGAGTGAGTGTGCGTAGGATTTACGACGTTTACTTTGAAAAAATTAGAGTGTTCAAAGTATTTCGTTGTCAGAGGTGAAATTCTTGGATTTACGAAAGACGAACAACTGCGAAAGCACTTGCCAAGAGTGTTTTCA
ASV58	AGCTCCAATAGCGTATATTAAAGTTGTTGTGGTTAAATAGCTCATAGTTGGATCTCAGCTCCAGACCGACGGTACGCCACCCAGCGTCTACTGTCTGCTTCCAAACTTTGAAAAAATTAGGGTGCTCAGAGCAGGCCAAGGCACCTGAAAACTTGTGCATGGAATAATGGAATAGGATGGTACTAGGTTTGATTTGTTGGTTTATGAGCCCGAGTTAATGATTAAGAGAAACAGACGGGGGCATTTGTTTTGCGACGTTAGGGGTGAAAGTCTTGGATTGTCGAAGATGAACGACTGCGAAAGCATTTGCCAAGAGTGTTT
ASV59	AGCTCCAATAGCGTATTTTAAAGTTGTTGTGGTTAAAAAGCTTGTAGTTGGATCTCGGCGGACTGAGGGCGGCTTGCTTGTTAGTATTGCTGCCCTTTAGTCCATAGTTTTGCCCGAGGTTTCGGGGTGCTCTTTATTGAGTGTCCCGGGAAACTGCCTGGTTTTCTTTGAAAAAATTAGAGTGCTATTTTGTTGATTTCAGAAATCGACTTAATGATTAACAGGGACACACGGAGGCATTTGTATTCAACCAACAAAGGTGAAATTCTTGGACCGTTAAAGACAAACTACTTCGAAAGCCTTTGCCAAGAATATTT
ASV60	GTTGGTAAATCTCGTGCCAGCCACCGCGGTTATACGAGTGACCCTTATTAATATTTTCCCGGCGTAAAGAGTGGTTTAAGAAAACCTTAAACAACTAAAGTTAAGACCTCATCAAGCTGTTATACGCTCTTATGAGAGGAATTATCAACAACGAAAGTGACTTTATAATATTAGAGACCTTGATGCCACGACAGTTGGGTCCCAAACTAGGATTATATACCCCACTATG
ASV61	AGCTCCAATAGCGTATATTAAAGTTGTTGTGGTTAAAAAGCTCGTAGTTGGATCTCGGCGGTCTGAGGGCGGTCTGAGGGCGGTTACTTTGAAAAAATTAGAGTGCTCAAAGCAGGCTTTTACGCCTGAATATTCGTGCATGGAATAATAGAATAGGAAGTCGTTTCTATTTTGTTGGTTTTCGGAAATCGACTTAATGATTAATAGGGACAGTCGGGGGCATTTGTATTCAAACGACAGAGGTGAAATTCTTGGACCGTTTGAAGACAAACTACTGCGAAAGCATTTGCCAAGAATGTTT
ASV62	AGCTCCAATAGCGTATATTAAAGTTGTTGTGGTTAAAAAGCTCGTAGTTTTGCCAGAGGTTTCGGGGTGCTCTTAATCGAGTGTCCCGGGATGCTGGCAGGTTTACTTTGAAAAAATTAGAGTGCTCAAAGCAGGCTATTACGCCTGAATATTCGTGCATGGAATAATAGAATAGGAAGTCGTTTCTATTTTGTTGGTTTTCGGAAATCGACTTAATGATTAATAGGGACAGTCGGGGGCATTTGTATTCAAACGACAGAGGTGAAATTCTTGGACCGTTTGAAGACAAACTACTGCGAAAGCATTTGCCAAGAATGTTT
ASV63	GTTGGTAAATCTCGTGCCAGCCACCGCGGTTATACGAGTGGCCCAAGTTGACAGACACTCGGCGTAAAACGTGGCTAGGCTAAACACTCAAACTAAAGCCGAACACCTTCTAAGCTGTGATACGCAATCGAAGGCAGGAAGCCCCACCACGAAAGTGGCTTTAACCTGAGCTGAACCCACGAAAGCTAGGGAACAAACTAGGATTAGATACCCCACTATG
ASV64	AGCTCCAATAGCGTATATTAAAGTTGTTGCAGTTAAAAAGCTCGTAGTTGGATTTCGGAGTGGGCCAGTTGGTCCGCCGCAAGGTGTGTTACTGACTGGTTTGCTCTTTACTTTGAAAAAATTAGAGTGTTCAAAGCAGGCTATTGCTTGAATACATGAGCATGGAATAATGGAATAGGACTTTGGTCCCATTTTGTTGGTTTCTAGGGCCGAAGTAATGATTAAGAGGGACAATTGGGGGCATCCGTATTTCGTTGTCAGAGGTGAAATTCTTGGATTTACGAAAGACGAACAACTGCGAAAGCACTTGCCAAGAGTGTTT
ASV65	AGCTCCATTAGTATATATCATTGTTGTTGTGGTTAAAAAGCTCGTAGTTGGATCTCTTCGGTTTTAGATCGGTTCACTTTTTGGGTGCTACTGATCTATAGGCCGTACTTTTGTCAGAGGTCTCAGGGTGCTCTTAATCGAGTGTCTTGTGATGCTGGCAGGTTTACTTTGAAAAAATTAGAGTGCTCAAAGCAGGCTTTTACGCCTGAATATTCGTGCATGGAATAATAGAATAGGAAGTCGTTTCTATTTTGCCAAGAATGTTT
ASV66	AGCTCCAATAGCGTATATTAAAGTTGTTGTGCTCTTATTCGAGTGTCCCGGGATGCTGGCAGGTTTACTTTGAAAAAATTAGAGTGCTCAAAGCAGGCTATTACGCCTGAATATTCGTGCATGGAATAATAGAATAGGAAGTCGTTTCTATTTTGTTGGTTTTCGGAAATCGACTTAATGATTAATAGGGACAGTCGGGGGCATTTGTATTCAAACGACAGAGGTGAAATTCTTGGACCGTTTGAAGACAAACTACTGCGAAAGCATTTGCCAAGAATGTTT
ASV67	GTTGGTAAATCTCGTGCCAGCCACCGCGGTTATACGAGCGACCCAAGTTGATAGACAACGGCGTAAAGGGTGGTTAAGATACTAATAAACTAAAGCCGAACGCCCTCAGGACTGTTATACGTTTCTGAAGGTAAGAAGTTCTACTACGAAAGTGGCTTTAATACTACTGACCCCACGAAAGCTGCGGAACAAACTAGGATTAGATACCCCACTATG
ASV68	GTTGGTAAATCTCGTGCCAGCCACCGCGGTCATACGATTGACCCAAGTTAATAGACACCCGGCGTAAAGAGTGTCGAGGAGTAATATAAAATAAAGTCAAATCTTAGTTAAGCTGTAAAAAGCCATAACTAAGCCTAAGCTAAACCACGAAAGTAACTTTATCACAAACCGAGTACACGACAACTAAGACCCAAACTAGGATTAGATACCCCACTATG
ASV69	AGCTCCAATAGCGTATATTAAAGTTGAGGCCTCGGGGTGCTCTTAACCGAGTGTCCTGCGGCGCTGGCGGGTTTACTTTGAAAAAATTAGAGTGCTCAAAGCAGGCTTTTACGCCTGAATATTCGTGCATGGAATAATAGAATAGGAAGTCGTTTCTATTTTGTTGGTTTTCGGAAATCGACTTAATGATTAATAGGGACAGTCGGGGGCATTTGTATTCAAACGACAGAGGTGAAATTCTTGGACCGTTTGAAGACAAACTACTGCGAAAGCATTTGCCAAGAATGTTT
ASV70	AGCTCCAATAGCGTATATTAAAGTTGTTGCGGTTAAAAAGCTCGTAGTTGGATCTCAGTTCCGGACCGACGGTACGCCACCCAGCGTCTACTGTCTGCTTCCAAACTTTGAAAAAATGAGGGTGCTCAGAGCAGGCCAAGGCACCTGAAAACTTGTGCATGGAATAATGGCATAGGATGGTACTAGGTTTGATTTGTTGGTTTATGAGCCCGAGGTAATGATTAAGAGAAACAGACGGGGGCATTTGTTTTGCGACGTTAGGGGTGAAAGTCTTGGATTGTCGAAGATGAACGACTGCGAAAGCATTTGCCAAGAGTGTTT
ASV71	AGCTCCAATAGCGTCTACTGTCGGCTTCCGAACGCTAAAGCCCGTCGGCTCGGTCGGGGTTGCTCTTCATCGAGTGTCCCGGGCGGCCGGCATGTTTACTTTGAAAAAATTAGGGTGCTCAGAGCAGGCCAAGGCGCCTGAATACTTGTGCATGGAATAATGGAATAGGACCTCGGTTCTATTTTGTTGGTTTTAAGAGCCCGAGGTAATGATTAACAGGAACAGACGGGGGCATCCGTATTGCGACGTTAGAGGTGAAATTCTTGGACCGTCGCAAGACGAACTACTGCGAAAGCATTTGCCAAGAATGTCT
ASV72	AGCTCCAATAGCGTATATTAAAGTTGTTGTGGTTAAAAAGCTCGTAGTTGGATCTCGGCGGACTGAGGGCGGTTTGCTCAAAGCAGGCTATTACGCCTGAATATTCGTGCATGGAATAATAGAATAGGAAGTCGTTTCTATTTTGTTGGTTTTCGGAAATCGACTTAATGATTAATAGGGACAGTCGGGGGCATTTGTATTCAAACGACAGAGGTGAAATTCTTGGACCGTTTGAAGACAAACTACTGCGAAAGCATTTGCCAAGAATGTTT
ASV73	AGCTCCAATAGCGTATATTAAAGTTGTTGCAGTTAAAAAGCTCGTAGTTGGATTTCATGAATACATGAGCATGGAATAATGGAATAGGACTTTGGTCCCATTTTGTTGGTTTCTAGGGCCGAAGTAATGATTAAGAGGGACAATTGGGGGCATCCGTATTTCGTTGTCAGAGGTGAAATTCTTGGATTTACGAAAGACGAACAACTGCGAAAGCACTTGCCAAGAGTGTTT
ASV74	AGCTCCATTAGTATATATCATTGTTGTTGTGGTTAAAAAGCTCGTAGTTGGATCTCTTCGGTTTTAGATCGGTTCACTTTTTGGGTGCTTTTTTTTGGGGGCATTTGTATTCAAACGACAGAGGTGAAATTCTTGGACCGTTTGAAGACAAACTACTGCGAAAGCATTTGCCAAGAATGTTTTCA
ASV75	AGCTCCAATAGCGTATATTAAAGTTGTTGTGGTTAAAAAGCTCGTAGTTGGATCTCGGCGGACTGAGGGCGGTTTGCTTGCTAGTATTACTGCCCTATAGTCCGTAGTTTTGCCAGAGGTTTCGGGGTGCTCTTAATCGAGTGTCCCGGGATGCTGGCAGGTTTACTTTGAAAAAATTAGAGTGCTCAAAGCAGGCTATTACGCCTGAATATTCGTGCATGGAATAATAGAATAGGAAGTCGTTTCTATTTTGTTGGTTTTCGGAAATCGACTTTGCATTTGCCAAGAATGTTT
ASV76	AGCTCCAATAGCGTATATTAAAGTTGTTGTGGTTAAAAAGCTTGTAGTTGGATCTCGGCGGACTAAGGGCGGCTTGCTTGTTAGTATTGCTGCCCTTTAGTCCATAGTTTTGCCCGAGGTTTCGGGGTGCTCTTTATTGAGTGTCCGGGGATGCTGCCTGGTTTTCTTTGAAAAAATTAGAGTGCTATTTTGTTGGTTTTCAGAAATCGACTTAATGATTAACAGGGAGACACGGAGGCATTTGTATTCAGACAACAAAGGTGAAATTCTTGGACCGTTTAAAGACAAACTACTGCGAAAGCATTTGCCAAGAATGTTT
ASV77	GTTGGTAAATCTCGTGCCAGCCACTGCAGTCATACGATTAACCCAAGCTAACAGGAATACGGTGTAAAACGTGTTAAAGCACCATACCAAATAGGATTAAATTCTAATTAAGCTGTAAAAAGCCATGATTAAAATAAAAATAAATGACGAAAGTGACCCTACGATAGCCGACACACTATAGCTAAGACCCAAACTAGGATTAGATACCCCACTATG
ASV78	GTTGGTAAATCTCGTGCCAGCCACCGCGGCCATACGATTAACCCAAACTAATAGACCCACGGCGTAAAGCGTGTTACAGAGAAAAAAATATACTAAAGTTAAATTTTAACTAGGCCGTAGAAAGCTACAGTTAACATAAAAATACAGCACGAAAGTAACTTTAACACCTCCGACTACACGACAGCTAAGACCCAAACTAGGATTAGATACCCCACTATG
ASV79	AGCTCCAATAGCGTATATTAAAGTTGTTGCGGTTAAAAAGCTCGTAGTTGGATCTCGGCAAGTAGAGGGCGGTATGCTTCGTAGCATTACTGCCCTATTACTTGTAGTTTTGCCAGAGGTTCCTGGGTGCTCTTAATCGAGTGTCTAGGGATGCTGGCAGGTTTACTTTGAAAAAATTAGAGTGCTCAAAGCAGGCTATTACGCTTGAATATTCGTGCATGGAATAATAGAATAGGAAGTTGTTTCTATTTTGTTGAAATTCTTGGACCGTTTGAAGACAAACTACTGCGAAAGCATTTGCCAAGAATGTTT
ASV80	AGCTCCAATAGCGTATATTAAAGTTGTTGCGGTTAAAAAGCTCGTAGTTGGATCTCGGCAAGTAGAGGGCGGTATGCTTCGTAGCATTACTGCCCTATTACTTGTAGTTTTGCCAGAGGTTCCTGGGTGCTCTTAATCGAGTGTCTAGGGATGCTGGCAGGTTTACTTTGAAAAAATTAGAGTGCTCAAAGCAGGCTATTACGCTTGGACCGTTTGAAGACAAACTACTGCGAAAGCATTTGCCAAGAATGTTTTCA
ASV81	AGCTCCAATAGCGTATATTAAAGTTGTTGTGGTTAAAAAGCTTGTAGTTGGATCTCGGCTGACTGAGGGCGGCTTGCTTGTTAGTATTGCTGCCCTTTAGTCCATAGTTTTGCCCGAGGTTTCGGGGTGCTCTTTATCGAGTGTCCCGGGATGCTGCCTGGTTTTCTTTGAAAAAATTAGAGTGCTATTTTGTTGGTTTTCAGAAATCAACTTAATGAGTAACAGGGACACACGGAGGCATTTGTATTCAGACGACAAAGGTGAAATTCTTGGACCGTTTAAAGACAAACTACTTCGAAAGCCTTTGCCAAGAATATTT
ASV82	AGCTCCAATAGCGTATATTACTTTGAAAAAATTAGAGTGCTCAAAGCAGGCTATTACGCCTGAATATTCGTGCATGGAATAATAGAATAGGAAGTCGTTTCTATTTTGTTGGTTTTCGGAAATCGACTTAATGATTAATAGGGACAGTCGGGGGCATTTGTATTCAAACGACAGAGGTGAAATTCTTGGACCGTTTGAAGACAAACTACTGCGAAAGCATTTGCCAAGAATGTTT
ASV83	GTTGGTAAATCTCGTGCCAGCCACCGCGGTCATACGATTGACCCAAGTTAATAGACACCCGGCGTAAAGAGTGTCGAGGAGTAACATAAAATAAAGTCAAATCTTAGTTAAGCTGTAAAAAGCCATAACTAAGCCTAAGCTAAACCACGAAAGTAACTTTATCACAAACCGAGTACACGACAACTAAGACCCAAACTAGGATTAGATACCCCACTATG
ASV84	AGCTCCAATAGTGTATATTAAAGTTGTTGCAGTTAAAAAGCTCGTAGTTGGATTTCGAGAAACGCATCTGGGTCACCAGTATGCTTTCTACCAGTCTTTGACTGTTACTGTGAGAAAATTAGAGTGTTTCAAGCAGGCAATTGCAGGAATACATTAGCATGGAATAACGAATGGGTCTACAATTTGGTTGATTGTAGATTGCGATTAATAGGGACAGTTGGGGGCATTAGTATTTAATTGTCAGAGGTGAAATTCTTGGATTAGTTAAAGACTAACGTATGCGAAAGCATTTGCCAAGGATGTTT
ASV85	AGCTCCAATAGCGTATATTAAAGTTGTTGTGGTTAAAAAGCTCGTAGTTGGATCTCGGCGGACTGAGGGCGGTTTGCTTGCTAGTATTACTGCCCTATAGTCCGTAGTTTTGCCAGAGGTTTCGGGGTGCTCTTAATCGAGTGTCCCGGGATGCTGGCAGGTTTACTTTGAAAAAATTAGAGTGCTCAAAGCAGGCTATTACGCCTGAATATTCGTGCATGGAATAATAGAATAGGAAGTCGTTTCTATTTTGCGAAAGCATTTGCCAAGAATGTTT
ASV86	AGCTCCAATAGCGTATATTAAAGTTGTTGCAGTTAAAAAGCTCGTAGTTGGATCTCAGGTGCAGGCGGGCGGTCCGGCTCGCGCCGGTCACTGCTCGTATCTCCTGCCCTACCGTTTGCCGGCTCTCTCCCGTGGGTGCTCTTCACTGAGCGTCCCGGGTGGCCGGTGCGTTTACTTTTTTGTTGGTTCTATTTTGTTGGTTTTCGGAACGGAGGTAACGATTAACAGGGACAAACGGGGGCATTCGTATTGCGGCGTTAGAGGTGAAATTCTTGGATCGCCGCAAGACGAGCTACTGCGAAAGCATTTGTCAATAATGTTT
ASV87	AGCTCCAATAGCGTATATTAAAGTTGTTGCGGTTAAAAAGCTCGTCGGCTCGGTCGGGGTTGCTCTTCATCGAGTGTCCCGGGCGGCCGGCATGTTTATTTTGAAAAAAATTAGTGTGCTCAGAGCAGGCCAAGGCGCCTGAATACTTGTGCATGGAATAATGGAATAGGACCTCGGTTCTATTTTGTTGGTTTTAAGAGCCCGAGGTAATGATTAACAGGAACAGACGGGGGCATCCGTATTGCGACGTTAGAGGTGAAATTCTTGGACCGTCGCAAGACGAACGACTGCGAAAGCATTTGCCAAGGATGTTT
ASV88	AGCTCCAATAGCGTATATTAAAGTTGTTGCAGTTAAAAAGCTCGTAGTTGGATTTCGGAGTGGGCCAGTTGGTCCGCCGCAAGGTGTGTTACTGACTGGTTTGCTCTTCTTCGCAAAGACTGCGTGTGCTCTTGAGTGAGTGTGCGTAGGATTTACGACGTTTACTTTGAAAAAATTAGAGTGTTCAAAGCAGGCTATTGCTTGAAGCATCCGTATTTCGTTGTCAGAGGTGAAATTCTTGGATTTACGAAAGACGAACAACTGCGAAAGCACTTGCCTAGAGTGTTT
ASV89	AGCTCCGATAGCGTATATTAAAGTTGTTGCGGTTAAAAAGCAGGCTATTACGCTTGAATATTCGTGCATGGAATAATAGAATAGGAAGTTGTTTCTATTTTGTTGGTTTTCGGAAATCGACTTAATGATTAATAGGGACAGTCGGGGGCATTTGTATTCAAACGACAGAGGTGAAATTCTTGGACCGTTTGAAGACAAACTACTGCGAAAGCATTTGCCAAGAATGTTT
ASV90	AGCTCCAATAGCGTATATTAAAGTTGTTGCGGTTAAAAAGCTCGTAGTTGGATCTCGGCAAGTAGAGGGCTATTACGCTTGAATATTCGTGCATGGAATAATAGAATAGGAAGTTGTTTCTATTTTGTTGGTTTTCGGAAATCGACTTAATGATTAATAGGGACAGTCGGGGGCATTTGTATTCAAACGACAGAGGTGAAATTCTTGGACCGTTTGAAGACAAACTACTGCGAAAGCATTTGCCAAGAATGTTT
ASV91	AGCTCAGATAGCGTATTTTAAAGTTGTTGCGGTTAAAAAGCTTGTAGTTGGATCTCAGTTCCGGACCGACGGTACGCCGCCCAGCGTCTACTGTCGGCTTCCGAACACTAAAGCCTGTCAGCTCAGTCGGGGTGCTCTTCATCGAGTGCCTCTGTTCTATTTTGGTAGTTTTACGAACCCGAGGTAATGATTAATAGGAACAGACGGGGGCATTCATATTGCAACGTTAGAGGTGAAATTCTTGGATCGTCGCAAGACGAACTACTGCAAAAGCATTTGCCAAGAATATTT
ASV92	AGCTCCAATAGCGTATATTAAAGTTGTTGTGGTTAAAAAGCTTGTAGTTGGATCTCGGCGGACTGAGGGCGGCTTGCTTGTTAGTATTACTGCCCTTTAGTCCATAGTTTTGCCCGAGGTTTCGGGGTGCTCTTTATCGAGTGTCCCGGGATGCTGCCTGGTTTTCTTTGAAAACATCAGAGTGCTATTTTGTTGGTTTTCAGAAATCGACTTAATGATTAACAGGGACACCCGGAGGCATTTGTATTCAGACGACAAAGGTGAAATTCTTGGACCGTTTAAAGACAAACTACTTCGAAACCCTTTGCCAAGAATATTT
ASV93	AGCTCCAATAGCGTATATTAAAGTTGTTGTGGTTAAAAAGCTCGTAGTTGGATCTCGGCGGACTGAGGGCGGTTTGCTTGCTAGTATTACTGCCCTATAGTCCGTAGTTTTGCCAGAGGTTTCGGGGTGCTCTTAATCGAGTGTCCCGGGATGCTGGCAGGTTTACTTTGAAAAAATTAGAGTGCTCAAAGCAGGCTATTACGCCTGAATATTGATAGGGACAGTCGGGGGCATTTGTATTCAAACGACAGAGGTGAAATTCTTGGACCGTTTGAAGACAAACTACTGCGAAAGCATTTGCCAAGAATGTTT
ASV94	AGCTCCAATAGCGTATATTAAAGTTGTTGTGGTTAAAAAGCTCGTAGTTGGATCTCGGCGGACTGAGGGCGGTTTGCTTGCTAGTATTACTGCCCTATAGTCCGTAGTTTTGCCAGAGGTTTCGGGGTGCTCTTAATCGAGTGTCCCGGGATGCTGGCAGGTTTACTTTGAAAAAATTAGAGTGCTCAAAGCAGGCTATTACGCCTGAATATTCGTGCATGGATATTCAAACGACAGAGGTGAAATTCTTGGACCGTTTGAAGACAAACTACTGCGAAAGCATTTGCCAAGAATGTTT
ASV95	AGCTCCAATAGCGTATATTAAAGTTGTTGTGGTTAAAAAGCTCGTAGTTGGATCTCGGCGGACTGAGTGCTCAAAGCAGGCTATTACGCCTGAATATTCGTGCATGGAATAATAGAATAGGAAGTCGTTTCTATTTTGTTGGTTTTCGGAAATCGACTTAATGATTAATAGGGACAGTCGGGGGCATTTGTATTCAAACGACAGAGGTGAAATTCTTGGACCGTTTGAAGACAAACTACTGCGAAAGCATTTGCCAAGAATGTTT
ASV96	GTCGGTAAAACTCGTGCCAGCCACCGCGGTTATACGAGAGACCCTAGTTGATATACTCGGCGTAAAGAGTGGTTATGGAAAACAAGCACTAAAGCCAAAGAGCCCTCAGGCCGTTATACGCACCCGGGGCCTCGAACCACTATCACGAAAGTAGCTTTACCCTCGCCCACCAGAACCCACGAGAGCTGGGACACAAACTGGGATTAGATACCCCACTATG
ASV97	GTTGGTAAATCTCGTGCCAGCCACCGCGGTTATACGAGAGGCCCAAGTTGAAAGACCCCGGCGTAAAGAGTGGTTAAGCTAGTTTTTATATTAAAGCCAAACACCCTCACGGCTGTTATACGCACCCGAAGATAAGAAGCTCAACCACGAAGGTGGCTTTATATGCCTGAACCCACGAAAGCTACGGCACAAACTAGGATTAGATACCCCACTATG
ASV98	AGCTCCAATAGCGTATATTAAAGTTGTTGTGGTTAAAAAGCTCGTAGTTGGATCTCAACAGCCTTGAAGCGGTTAACTTTGTAGTTTTACTGCTTTATAGGCTGTGCTTTTGCTGGAGGTTTAGGGGTGCTCTTGATCGAGTGTCTCTGGATGCCAGCAGGTTTACTTTGGAAAAATTAGAGTGCTCAAAGCAGGCTAAAATGCCTGAATATTCGTGCATGGAATAATAGAATAGGATGTCGATCCTATTTTGTTGGTTTTCGGGAAATTCTTGGACCGTTTGAAGACAAACTACTGCGAAAGCATTTGCCAAGAATGTTT
ASV99	CTCGGTCCATTGTGGCACCCGCACGAGGCTGAGGTAGGCGCCCCCCAAGCCGGCACAGGCACCGCCGAACATGATCGCCAAAAGCCGGATACGGATTACCTTATAGCCCAGGGCATGGGCGGCATCATGGTTTTCGCCCACGCCACGTAAAATCAGCCCGGCTCGGCTGTATTTCAGCACAGCCCAGACCGCAAAGACCAGTGCAAGGCTGACATAGATCATCGGATCATGTGAAAACACGATCGGGCCCAAAACTGGAATATCGGACAGACCGGGGATATCAAGCGCCGGCAATGTTGGCGATTTCATCCCTTCATAGGGT
ASV100	TTCTATTTCAGCAGAACCAACATCTATTGCTGAGCCACAATCTAATGATCAATCTATAACATCCCCAATGGTAGGAACGTATTATTCAGCGCCCTCACAACAGCTAAGCCATTTATCACGGTGGGTCAAAAAATACAGCAGGGCGACACCGTAGGCATTATAGAAGCTATGAAAATCATGAATCAAATAGAGGCTGACCACTCAGGAACAGTAATAGAGATACTCGTTAAAGATGGCGAAGCAGTTGAATTTGGACAACCATTAATCATAGTTCAATGAATTCTATAAAAAAAGTATTGA
ASV101	AGCTCCAATAGCGTATATTAAAGTTGCTGCCCTATTACTTGTAGTTTTGCCAGAGGTTCCTGGGTGCTCTTAATCGAGTGTCTAGGGATGCTGGCAGGTTTACTTTGAAAAAATTAGAGTGCTCAAAGCAGGCTATTACGCTTGAATATTCGTGCATGGAATAATAGAATAGGAAGTTGTTTCTATTTTGTTGGTTTTCGGAAATCGACTTAATGATTAATAGGGACAGTCGGGGGCATTTGTATTCAAACGACAGAGGTGAAATTCTTGGACCGTTTGAAGACAAACTACTGCGAAAGCATTTGCCAAGAATGTTT
ASV102	AGCTCCAATAGCGTATATTAAAGTTGTTGCGGTTAAAAAGCGCTTGAATATTCGTGCATGGAATAATAGAATAGGAAGTCGTTTCTATTTTGTTGGTTTTCGGAAATCGACTTAATGATTAATAGGGACAGTCGGGGGCATTTGTATTCAAACGACAGAGGTGAAATTCTTGGACCGTTTGAAGACAAACTACTGCGAAAGCATTTGCCAAGAATGTTT
ASV103	AGCTCCAATAGCGTATATTAAAGTTGTTGCGGTTAAAAAGCTCGTAGTTGGATCTCAGTTCCGGACCGACGGTACGCCGCCCGGCGTCTACTGTCGGCTTCCGAACGCTAAAGCCCGTCGGCTCGGTCGGGGTGCTCTTCATCGAGTGTCCCGGGCGGCCGGCATGTTTACTTTGAAAAAATTAGGGTGCTCAGAGCAGGCCAAGGCGCCTGAATACTTGTGCATGGACGGGGGCATCCGTATTGCGACGTTAGAGGTGAAATTCTTGGACCGTCGCAAGACGAACTACTGCGAAAGCATTTGCCAAGAATGTCT
ASV104	AGCTCCAATAGCGTATATTAAAGTTGTTGCGGTTAAAAAGCTCGTAGTTGGATCTCAGTTCCGGACCGACGGTACGCCGCCCGGCGTCTACTGTCGGCTTCCGAACGCTAAAGCCCGTCGGCTCGGTCGGGGTGCTCTTCATCGAGTGTCCCGGGCGGCCGGCATGTTTACTTTGAAAAAATTAGGTTTTAAGAGCCCGAGGTAATGATTAATAGGAACAGACGGGGGCATTCGTATTGCGACGTTAGAGGTGAAATTCTTGGATCGTCGCAAGACGAACTACTGCGAAAGCATTTGCCAAGAATGTTT
ASV105	AGCTCCAATAGCGTATATTAAAGTTGTTGCAGTTAAAAAGCTCGTAGTTACATGAGCATGGAATAATGGAATAGGACTTTGGTCCCATTTTGTTGGTTTCTAGGGCCGAAGTAATGATTAAGAGGGACAATTGGGGGCATCCGTATTTCGTTGTCAGAGGTGAAATTCTTGGATTTACGAAAGACGAACAACTGCGAAAGCACTTGCCAAGAGTGTTT
ASV106	AGCTCCAATAGCGTATATTAAAGTTGTTGCGGTTAAAAAGCTCGTAGTTGGATCTCAGTTCCGGACCGACGGTACGCCGCCCGGCGTCTACTGTCGGCTTCCGAACGCTAAAGCCCGTCGGCTCGGTCGGGGTGCTCTTCATCGAGTGTCCCGGGCGGCCGGCATGTTTACTTTGAAAAAATTAGGGTGCTCAGAGCAGGCCCGAGGTAATGATTAATAGGAACAGACGGGGGCATTCGTATTGCGACGTTAGAGGTGAAATTCTTGGATCGTCGCAAGACGAACTACTGCGAAAGCATTTGCCAAGAATGTTT
ASV107	AGCTCCAATAGCGTATATTAAAGTTGTTGCGGTTAAAAAGCTCGTAGTTGGATCTCGGCAAGTAGAGGGCGGTATGCTTCGTAGCATTACTGCCCTATTACTTGTAGTTTTGCCAGAGGTTCCTGGGTGCTCTTAATCGAGTGTCTAGGGATGCTGGCAGGTTTACTTTGAAAAAATTAGAGTGCTCAAAGCAGGCTATTACGCTTGAATATTCGCATTTGTATTCAAACGACAGAGGTGAAATTCTTGGACCGCTTGAAGACAAACTACTGCGAAAGCATTTGCCAAGAATGTTT
ASV108	AGCTCCAATAGCGTATATTAAAGTTGTTGCGGTTAAAAAGCTCGTAGTTGGATCTCGGCAAGTAGAGGGCGGTATGCTTCGTAGCATTACTGCCCTATTACTTGTAGTTTTGCCAGAGGTTCCTGGGTGCTCTTAATCGAGTGTCTAGGGATGCTGGCAGGTTTACTTTGAAAAAATTAGAGTGCTCAAAGCAGGCTATTACGCTTGAAGACAAACTACTGCGAAAGCATTTGCCAAGAATGTTTTCA
ASV109	AGCTCCAATAGCGTATATTAAAGTTGTTGTGGTTAAAAAGCTCGTAGTTGGATCTCGGCGGACTGAGGGCGGTTTGCTTGCTAGTATTACTGCCCTATAGTCCGTAGTTTTGCCAGAGGTTTCGGGGTGCTCTTAATCGAGTGTCCCGGGATGCTGGCAGGTTTACTTTGAAAAAATTAGAGTGCTCAAAGCAGGCTATTACGCCTGAATATTCGTGCATGGAATAATAGAATAGGAAGTCGTTTCTATTTTGTTGGTGAAATTCTTGGACCGTTTGAAGACAAACTACTGCGAAAGCATTTGCCAAGAATGTTT
ASV110	AGCTCCAATAGCGTATATTAATGTTGCTGCAGTTAAAACGCTCGTAGTTGTTGTCCAACTATACGCCGCACTTCTTCGGAAGACGTGGTTCAATAGTTTAGCGGGGATGACCTGCCAAAACCTTGAGGAAAGATTAGTGTTCTAAGCAATTAATTTTGACCTCTCCAGCATGGTATATAACCAAACAGAGGAAGATACTTGCCACATCTTCATCATACTAAATAGAAATTCAAGGGGGTATACGTACTTTAATGTCAGAGGTGAGATTCCTAGATTTTTAAGAGACGATCAAATGCGAAAGCATTCACCAAGCGACTTTTCT
ASV111	ACGTTTTTGACCTGAACGTTCTAATTGATATCTCATATCTCTAACTAGATTTCTAAATGCAGTTCTAAACAAATCTGCAAGCATTTGTCCTGCAAATTTGATTACTTTATTTCCATAATGATCTTTATCATCAGGAGTAATCCAACCAAGTTTTAATTCTAATAATTTGCAAGCTGCTTCACCTAAGAATTGTGCTTTTTCTTTTCTATTTTCAGGATGTTTACCCAAATGAGGCAACAAACC
ASV112	AGCTCCAATAGCGTATATTAAAGTTGTTGTGGTTAAAAAGCTCGTAGTTGGATCTCGGCGGACTGAGGGCGGTTTGCTTGCTAGTATTACTGCCCTATAGTCCGTAGTTTTGCCAGAGGTTTCGGGGTGCTCTTAATCGAGTGTCCCGGGATGCTGGCAGGTTTACTTTGAAAAAATTAGAGTGCTCAAAGCAGGCTATTACGCCTGTATTTGTATTCAAACGACAGAGGTGAAATTCTTGGACCGTTTGAAGACAAACTACTGCGAAAGCATTTGCCAAGAATGTTT
ASV113	AGCTCCAATAGGGTATATTAAAGTTGTTGCGGTTAAAAAGCTCGTAGTTGGGTGCTCTTAATCGAGTGTCTAGGGATGCTGGCAGGTTTACTTTGAAAAAATTAGAGTGCTCAAAGCAGGCTATTACGCTTGAATATTCGTGCATGGAATAATAGAATAGGAAGTTGTTTCTATTTTGTTGGTTTTCGGAAATCGACTTAATGATTAATAGGGACAGTCGGGGGCATTTGTATTCAAACGACAGAGGTGAAATTCTTGGACCGTTTGAAGACAAACTACTGCGAAAGCATTTGCCAAGAATGTTT
ASV114	AGCTCCAATAGCGTATATTAAAGTTGTTGTGGTTAAAAAGCTCGTAGTTGGATCTCGGCGGACTGAAAAAATTAGAGTGCTCAAAGCAGGCTATTACGCCTGAATATTCGTGCATGGAATAATAGAATAGGAAGTCGTTTCTATTTTGTTGGTTTTCGGAAATCGACTTAATGATTAATAGGGACAGTCGGGGGCATTTGTATTCAAACGACAGAGGTGAAATTCTTGGACCGTTTGAAGACAAACTACTGCGAAAGCATTTGCCAAGAATGTTT
ASV115	AGCTCCAATAGCGTATATTAAAGTTGTTGCGGTTAAAAAGCTCGTAGTTGGATCTCGGCAAGTAGAGGGCGGTATGCTTCGTAGCATTACTGCCCTATTACTTGTAGTTTTGCCAGAGGTTCCTGGGTGCTCTTAATCGAGTGTCTAGGGATGCTGGCAGGTTTACTTTGAAAAAATTAGAGTGCTCAAAGCAGGCTATTACGCTTGAATATTCTTGGACCGCTTGAAATTCTTGGACCGTTTGAAGACAAACTACTGCGAAAGCATTTGCCAAGAATGTTT
ASV116	AGCTCCAATAGCGTATATTAAAGTTGTTGTGGTTAAAAAGCTCGTAGTTGGATCTCGGCGGACTGAGGGCGGTTTGCTTGCTAGTATTACTGCCCTATAGTCCGTAGTTTTGCCAGTATTTGCCAGTTTTTGAATATTCGTGCATGGAATAATAGAATAGGAAGTCGTTTCTATTTTGTTGGTTTTCGGAAATCGACTTAATGATTAATAGGGACAGTCGGGGGCATTTGTATTCAAACGACAGAGGTGAAATTCTTGGACCGTTTGAAGACAAACTACTGCGAAAGCATTTGCCAAGAATGTTT
ASV117	AGTGCCAATAGCGCAAATTAAAGCTGTTCTGGTGAAAAAGCTTGTAGTTGGATCTCGGCGGACTCAGGGCGGTTTGCTTGCTAGTATTACTGCCCTATAATCCGAAGTTTTTCAGGGGCATTCTTAAAATTCTTGGACCATTTGAAGACAAAATACTGCGAAGGCATTTGCCAAGAATGTTTTCA
ASV118	AGCTCCAATAGCGTATATTAAAGTTGTTGTGGTTAAAAAGCTCGTAGTTGGATCTCGGCGGACTGAGGGCGGTTTGCTTGCTAGTATTACTGCCCTATAGTCCGTAGTTTTGCCAGAGGTTTCGGGGTGCTCTTAATCGAGTGTCCCGGGATGCTGGCAGGTTTACTTTGAAAAAATTAGAGTGCTCAAAGCAGGCTATTACGCCTGAATATTCTTGGACCGTTTGAAGACAAACTACTGCGAAAGCATTTGCCAAGAATGTTTTCA
ASV119	AGCTCCAATAGCGTATATTAAAGTTGTTGCGGTTAAAAAGCTCGTAGTTGGATCTCGGCAAGTAGAGGGCGGTATGCTTCGTAGCATTACTGCCCTATTACTTGTAGTTTTGCCAGAGTGCTCAAAGCAGGCTATTACGCTTGAATATTCGTGCATGGAATAATAGAATAGGAAGTTGTTTCTATTTTGTTGGTTTTCGGAAATCGACTTAATGATTAATAGGGACAGTCGGGGGCATTTGTATTCAAACGACAGAGGTGAAATTCTTGGACCGTTTGAAGACAAACTACTGCGAAAGCATTTGCCAAGAATGTTT
ASV120	AGCTCCAATAGCGTATATTAAAGTTGTTGTGGTTAAAAAGCTCATAGTTGGATCTCAGCTCCAGACCGACGGTACGCCACCCAGCGTCTACTGTCTGCTTCCAAACTTTGAAAAAATGAGGGTGCTCAGAGCAGGCCAAGGCACCTGAAAACTTGTGCATGGAATAATGGAATAGGATGGTACTAGGTTTGATTTGTTGGTTTATGAGCCCGAGGTAATGATTAAGAGAAACAGACGGGGGCATTTGTTTTGCGACGTCAGGGGTGAAAGTCTTGGATTGTCGAAGATGAACGACTGCGAAAGCATTTGCCAAGAGTGTTT
ASV121	AGCTCCAATAGCGTATATTAAAGTTGTTGCGGTTAAAAAGCTCGTAGTTGGATCTCGGCAAGTAGAGGGCGGTATGCTTCGTAGCATTACTGCCCTATTACTTGTAGTTTTGCCAGAGGTTCCTGGGTGCTCTTAATCGAGTGTCTAGGGATTTGTATTCAAACGACAGAGGTGAAATTCTTGGACCGTCTGAAGACAAACTACTGCGAAAGCATTTGCCAAGAATGTTTTCA
ASV122	AGCTCCAATAGCGTATATTAAAGTTGTTGTGGTTAAAAAGCTCGTAGTTGGATATCGGCGGACTGAGGGCCGTTTGCTTGCTAGTATTACTGCCCTATAGTCCGTAGTTTTGCCAGAGGTTTCGGGGTGCTCTTAATATTCGTGCATGGAATAATAGAATAGGAAGTCGTTTCTATTTTGTTGGTTTTCGGAAATCGACTTAATGATTAATAGGGACAGTCGGGGGCATTTGTATTCAAACGACAGAGGTGAAATTCTTGGACCGTTTGAAGACAAACTACTGCGAAAGCATTTGCCAAGAATGTTT
ASV123	AGCTCCGATAGCGTATATTAAAGTTGTTGCAGTTAAAACGTCCATAGTTTTGCCAGAGGTTTCAGGGTGCTCTTAATCAAGTGTCCCGGGATGCTGGCAGGTTTACTTTGAAACAATTAGAGTGCTCAAAGCAGGCTATTAGGCCTGAATATTCGTGCATGGAATAATAGAATAGGAAGTCGTTTCTATTTTGTTGGTTTTCGGAAATCGACTTAATGATTAATAGGGACAGTCGGGGGCATTTGTATTCAAACGACAGAGGTGAAATTCTTGGACCGTTTGAAGACAAACTACTGCGAAAGCATTTGCCAAGAATGTTT
ASV124	AGCTCCAATAGCGTATATTAAAGTTGTTGCGGTTAAAAAGCTCGTAGTTGGATCTCAGTTCCGGACCGACGGTACGCCGCCCGGCGTCTACTGTCGGCTTCCGAACGCTAAAGCCCGTCGGCTCGGTCGGGGTGCTCTTCATCGAGTGTCCCGGGCGGCCGGCATGTTTACTTTGAAAAAATTAGGGTGCTCAGAGCAGGCCAAGGTGCCTGAATACTTGTGCATGGAATAATGGAATAGGACCTCGGTTCTATTTTGTTGGTTTTAAGAGCCCGAGGTAATGATTAACAGGAACAGGCGAAAGCATTTGCCAAGAATGTTT
ASV125	AGCTCCAATAGCGTATATTAAAGTTGTTGTGGTTAAAAAGCTCATAGTTGGATCTCAGCTCCAGACCGACGGTACGCCACCCAGCGTCTACTGTCTGCTTCCAAACTTTGAAAAAATGAGGCACCTGAAAACTTGTGCATGGAATAATGGAATAGGATGGTACTAGGTTTGATTTGTTGGTTTATGAGCCCGAGGTAATGATTAAGAGAAACAGACAGGGGCATTTGTTTTGCGACGTTAGGGGTGAAAGTCTTGGATTGTCGAAGATGAACGACTGCGAAAGCATTTGCCAAGAGTGTTT
ASV126	AGCTCCAATAGCGTATATTAAAGTTGTTGTGGTTAAAAAGCTCGTAGTTGGATCTCGGCGGTCTGAGGGCGGTTCGCTTCAGAGCGCTACTGCCCTATAGACCGTAGTTTTGCCAGTCGGGACAGTCGGGGGCATTTGTATTCAAACGACAGAGGTGAAATTCTTGGACCGTTTGAAGACAAACTACTGCGAAAGCATTTGCCAAGAATGTTTTCA
ASV127	AGCTCCAATAGCGTATATTAAAGTTGTTGCGGTTAAAAAGCTCGTAGTTGGATCTCGGCAAGTAGAGGGCGGTATGCTTCGTAGCATTACTGCCCTATTACTTGTAGTTTTGCCAGAGGTTCCTGGGTGCTCTTAATCGAGTGTCTAGGGATGCTGGCAGGTTTACTTTGAAAAAATTAGAGTGCTCAAATTCTTGGACCGTTTGAAGACAAACTACTGCGAAAGCATTTGCCAAGAATGTTTTCA
ASV128	AGCTCCAATAGCGTATATTAAAGTTGTTGCGGTTAAAAAGCTCGTAGTTGGATCTCGGCAAGTAGAGGGCGGTATGCTTCGTAGCATTACTGCCCTATTACTTGTAGTTTTGCCAGAGGTTCCTGGGTGCTCTTAATCGAGTGTCTAGGGATGCTGGCAGGTTTACTTTGAAAAAATTAGAGTGCTCAAAGCAGGCTGTTTGTATTCAAACGACAGAGGTGAAATTCTTGGACCGTTTGAAGACAAACTACTGCGAGAGCATTTGCCAAGAATGTTT
ASV129	AGCTCCAATAGCGTATATTAAAGTTGTTGCGGTTAAAAAGCTCGTAGTTGGATCTCAGTTCCGGACCGACGGTACGCCGCCCGGCGTCCGGCATGTTTACTTTGAAAAAATTAGGGTGCTCAGAGCAGGCCAAGGCGCCTGAATACTTGTGCATGGAATAATGGAATAGGACCTCGGTTCTATTTTGTTGGTTTTAAGAGCCCGAGGTAATGATTAATAGGAACAGACGGGGGCATTCGTATTGCGACGTTAGAGGTGAAATTCTTGGATCGTCGCAAGACGAACTACTGCGAAAGCATTTGCCAAGAATGTTT
ASV130	AGCTCCAATAGCGTATATTAAAGTTGTTGCGGTTAAAAAGCTCGTAGTTGGATCTCAGTTCCGGACCGACGGTACGCCGCCCGGCGTCCGGCATGTTTACTTTGAAAAAATTAGGGTGCTCAGAGCAGGCCAAGGCGCCTGAATACTTGTGCATGGAATAATGGAATAGGACCTCGGTTCTATTTTGTTGGTTTTAAGAGCCCGAGGTAATGATTAACAGGAACAGACGGGGGCATCCGTATTGCGACGTTAGAGGTGAAATTCTTGGACCGTCGCAAGACGAACTACTGCGAAAGCATTTGCCAAGAATGTTT
ASV131	AGCTCCAATAGCGTATATTAAAGTTGTTGCGGTTAAAAAGCTCGTAGTTGGATCTCGGCAAGTAGAGGGCGGTATGCTTCGTAGCATTACTGCCCTATTACTTGTAGTTTTGCCAGAGGTTCCTGGGTGCTCTTAATCGAGTGTCTAGGGATGCTGGCAGGTTTACTTTGAAAAAATTAGAGTGCTCAAGCATTTGCCAAGAATGTTTTCA
ASV132	AGCTCCAATAGCGTATATTAAAGTTGTTGCGGTTAAAAAGCTCGTAGTTGGATCTCGGCAAGTAGAGGGCGGTATGCTTCGTAGCATTACTGCCCTATTACTTGTAGTTTTGCCAGAGGTTCCTGGGTGCTCTTAATCGAGTGTCTAGGGATGCTGGCAGGTTTACTTTGAAAAAATTAGAGTGCTCAAAGCAGGCTATTACGCTTGAATATTCGTGCATGACCCGACAAACTACTGCGAAAGCATTTGCCAAGAATGTTTTCA
ASV133	AGCTCCAATAGCGTATATTAAAGTTGTTGCGGTTAAAAAGCTCGTAGTTGGATCTCGGCAAGTAGAGGGCTCAAAGCAGGCTATTACGCTTGAATATTCGTGCATGGAATAATAGAATAGGAAGTTGTTTCTATTTTGTTGGTTTTCGGAAATCGACTTAATGATTAATAGGGACAGTCGGGGGCATTTGTATTCAAACGACAGAGGTGAAATTCTTGGACCGTTTGAAGACAAACTACTGCGAAAGCATTTGCCAAGAATGTTT
ASV134	AGCTCCAATAGCGTATATTAAAGTTGTTGCGGTTAAAAAGCTCGTAGTTGGATCTCGGCAAGTAGAGGGCGGTATGCTTCGTAGCATTACTGCCCTATTACTTGTAGTTTTGCCAGAGGTTCCTGGGTGCTCTTAATCGAGTGTCTAGGGATGCTGGCAGGTTTACTTTGAAAAAATTAGAGTGCTCAAAGCAGGCTATTACGCTTGAATATTCGTGCATGGAATAATAGAATAGGAAGTTGTTTCTATTTTGTTGGACCGTTTGAAGACAAACTACTGCGAAAGCATTTGCCAAGAATGTTT
ASV135	AGCTCCAATAGCGTATATTAAAGTTGTTGTGGTTAAAAAGCTTGTAGTTGGATCTCGGCGGACTGAGGGCGGCTTGCTTGCGAGGTTTCGGGGTGCTCTTTATCGAGTGTCCCGGGATGCTGCCTGGTTTTCTTTGAAAAAATTAGAGTGCTATTTTGTTGGTTTTCAGAAATCAACTTAATGAGTAACAGGGACACACGGAGGCATTTGTATTCAGACGACAAAGGTGAAATTCTTGGACCGTTTAAAGACAAACTACTTCGAAAGCCTTTGCCAAGAATATTT
ASV136	AGCTCCAATAGCGTATATTAAAGTTGTTGCGGTTAAAAAGCTCGTAGTTGGATCTCGGCAAGTAGAGGGCGGTATGCTTCGTAGCATTACTGCCCTATTACTTGTAGTTTTGCCAGAGGTTCCTGGGTGCTCTTAATCGAGTGTCTAGGGATGCTGGCAGGTTTACTTTGAAAAAATTAGAGTGCTCAAAGCAGGCTATTACGCTTGAATATTCGTGCATGGAATAATAGAAATTCTTGGACCGTTTGAAGACAAACTACTGCGAAAGCATTTGCCAAGAATGTTT
ASV137	AGCTCCAATAGCGTATATTAAAGTTGTTGCGGTTAAAAAGCTCGTAGTTGGATCTCGGCAAGTAGAGGGCGGTATGCTTCGTAGCATTACTGCCCTATTACTTGTAGTTTTGCCAGAGGTTCCTGGGTGCTCTTAATCGAGTGTCTAGGGATGCTGGCAGGTTTACTTTGAAAAAATTAGAGTGCTCAAAGCAGGCTATTACGCTTGAATATTCGTGCATGGAATAATAGAATAGGAAGTTGTTTCTATTTTGTTGGTTTTCGGAAATCGACTTAATGATTAATAGGGACAGTCGGGGGCATTTGCCAAGAATGTTT
ASV138	AGCTCCAATAGCGTATATTAAAGTTGTTGTGGTTAAAAAGCTCGTAGTTGGATCTCGGCGGACTGAGGGCGGTTTGCTTGCTAGTATTACTGCCCTATAGTCCGTGCATGCAGTATATTCGTGCATGGAATAATAGAATAGGAAGTCGTTTCTATTTTGTTGGTTTTCGGAAATCGACTTAATGATTAATAGGGACAGTCGGGGGCATTTGTATTCAAACGACAGAGGTGAAATTCTTGGACCGTTTGAAGACAAACTACTGCGAAAGCATTTGCCAAGAATGTTT
ASV139	AGCTCCAATAGCGTATATTAAAGTTGTTGCAGTTAAAAAGCTCGTAGTTGGATTTCGGAGTGAGCTAGTTGGTCCGCCGCAAGGTGTGTTACTGACTAGTTTGCTCTTCTTCGCAAAGACTGCGTGTGCTCTTGAGTGAGTGTGCGTAGGATTTACGACGTTTACTTTGAAAAAATTAGAGTGTTCAAAGCAGGCTATTGCTTGAATACATGAGCATGGAATAATGGAATAGGACTTTGGTCCCATTTTGTTGGTTTCTAGGACCGAAGTAATGATTAAGAGGGACAATTGAGTGTTT
ASV140	GTTGGTAAATCTCGTGCCAGCCACCGCGGTTATACGAGAGGCCCAAGTTGAAAGACACCGGCGTAAAGCGTGGTTAAGTTAAAATTTAAACTAAAGTTAAACATCTTCAAGACTGTTATACGTATCCGAAGACAGGAGTCTCAATCACGAAAGTAACTTTATCTAAACTGAACCCACGAAAGCTACGGCACAAACTAGGATTAGATACCCCACTATG
ASV141	GTTGGTAAATCTCGTGCCAGCCACCGCGGTTATACGAGAGGCCCAAGTTGAAAGACATCGGCGTAAAGAGTGGTTAAGTTAAAATTTATACTAAAGCCGAACATCCTCAAGGCTGTTATACGCACCCGAAGATAAGAAGTTCAACCACGAAAGTGGATTTATTTAAGCTGAACCCACGAAAGCTACGGCACAAACTAGGATTAGATACCCCACTATG
ASV142	AGCTCCAATAGCGTATATTAAAGTTGTTGTGGTTAAAAAGCTCGTAGTTGGATCTCAACAGCCTTGAAGCGGTTAACTTTGTAGTTTTACTGCTTTATAGGCTGTGCTTTTGCTGGCATTTGTATTCAAACGACAGAGGTGAAATTCTTGGACCGTTTGAAGACAAACTACTGCGAAAGCATTTGCCAAGAATGTTTTCA
ASV143	AGCTCTAATAGCGTATATTAATGTTGTTGCGGTTAAAAAGCTCGTAGTTGGATATCAACGGGTTAATAATGATAAATAGAGACTGTCGGGGGCATTTGTATTTGTAAGCGAGAGGTGAAATTCATTGACCTTACAAAGACAAACCAAAGCGAAAGCATTTGCCAAGAATGTCTTCA
ASV144	AATCTTAATTGAATAGAGATGCATAACGCAATTCAACTAGTTACTTTGAAAAAATCAAAGTGATTAATACAAGCAATTGCTTGAATATTTGTGCATGGGATAATAAAACAAGACTGTTAGCGAATCAGTTGGTTGTATCGCTAAAAGTAATGATAAATAGAGACTGTCGGGGGCATTTGTATTTGTAAGCGAGAGGTGAAATTCATTGACCTTACAAAGACAAACCAAAGCGAAAGCATTTGCCAAGAATGTCT
ASV145	AGCTCTAATAGCGTATATTAATGTTGTTGCGGTTAAAAAGCTCGTAGTTGGATATCAACGGGTTAATAGCAGTTTTGCGTGAGTAAAACAGTTGAAGCAAGGAAAATGAAATGCGGTAATTCTAATCTTAATTGAATAGAAATGCATAACGCAATTCAACTAGTTACTTTGAAAAAATCAAAGTGATTAACACAAGCATTTGTATTTGTAAGCGAGAGGTGAAATTCATTGACCTTACAAAGACAAACCAAAGCGAAAGCATTTGCCAAGAATGTCT
ASV146	AGCTCCAATAGCGTATATTAAAGTTGTTGTGGTTAAAAAGCTCGTAGTTGGATCTCAACAGCCTTGAAGCGGTTAACTTTGTAGTTTTACTGCTTTATAGGCTGTGCTTTTGCTGGAGGTTTAGGGGTGCTCTTGATCGAGTGTCTCTGGATGCCAGCAGGTTTACTTTGAAAAAATTAGAGTGCTCAAAGCAGGCTAAAATGCCTGAATATTCGTGCATGGAATAATAGAATAGGATGGACCGTTTGAAGACAAACTACTGCGAAAGCATTTGCCAAGAATGTTT
ASV147	AGCTCCAATAGCGTATATTAAAGTTGTTGTGGTTTGCTTTTGCTGGAGGTTTAGGGGTGCTCTTGATCGAGTGTCTCTGGATGCCAGCAGGTTTACTTTGAAAAAACTAGAGTGCTCAAAGCAGGCTAAAATGCCTGAATATTCGTGCATGGAATAATAGAATAGGATGTCGATCCTATTTTGTTGGTTTTCGGGACTCGACATAATGATAAATAGGGACAGTCGGGGGCATTTGTATTCAAACGACAGAGGTGAAATTCTTGGACCGTTTGAAGACAAACTACTGCGAAAGCATTTGCCAAGAATGTTT
ASV148	ACCAATAATTCCTACCTGAGAACCTTTCATGCGTGAATTTTTCTAATGTTATTAATAAACGTGTAAATTGTTAATAATAGTATATATAATGAAAGGGATTAATTATTAAAAATTATTAAGAAGTTTAATAATAAAAAACTTCAGATTATTAATTGTTGTAAATACATTAAATATTAAAAATTGTCATAAGGTAGTATGTCAAAGATTGTAAAATGTCCTAGCTGTGATTGTCATATTGTTGTAAATGAAAAAGGACAAAAAGAATTCTGTA
ASV149	AGCTCCAATAGCGTATACTAAAGTTGTGGTTAAAAAGCTCGTAGTTGGATATTGGAAGGTCGGGGGTACGGCCAGGTTAACTTAAAAAAAAATAGTGCTTCAAGCCCGGATACTCGTGCATGGAATAATGGAATAGGACGTAGTCACTATTTTGTTGGTTTTCGGAGATTGACGTTATGATTAACAGGGACAGTCTGGGGCATTGATATTGAGGAGCTAGAGGTGAAATTCTTGGACCTCCTCAAGACCAACCACTGCGAAAGCATTTGCCAAGGATGTTT
ASV150	AGCTCCAATAGCGTATATTAAAGTTGTTGCGGTTAAAAAGCTCGTAGTTGGATCTCGGCAAGTAGAGGGCGGTATGCTTCGTAGCATTACTGCCCTATTACTTGTAGTTTTGCCAGAGGTTCCTGGGTGCTCTTAATCGAGTGTCTAGGGATGCTGGCAGGTTTACTTTGAAAAAATTAGAGTGCTCAAAGCAGGCTATTACGCTTGAATATTCGTGCATGGAATAATAGAATAGGAAGTTGTTTCTATTTTGTTGAAGACAAACTACTGCGAAAGCATTTGCCAAGAATGTTT
ASV151	AGCTCCAATAGGTTCCTGGGTGCTCTTAATCGGGTGTCTAGGGATGCTGGCAGGTTTACTTTGAAAAAATTAGAGTGCTCAAAGCAGGCTATTACGCTTGAATATTCGTGCATGGAATAATAGAATAGGAAGTTGTTTCTATTTTGTTGGTTTTCGGAAATCGACTTAATGATTAATAGGGACAGTCGGGGGCATTTGTATTCAAACGACAGAGGTGAAATTCTTGGACCGTTTGAAGACAAACTACTGCGAAAGCATTTGCCAAGAATGTTT
ASV152	AGCTCCAATAGCGTATATTAAAGTTGTTGCGGTTAAAAAGCTCGTAGTTGGATCGGGTGCTCTTAATCGAGTGTCTAGGGATGCTGGCAGGTTTACTTTGAAAAAATTAGAGTGCTCAAAGCAGGCTATTACGCTTGAATATTCGTGCATGGAATAATAGAATAGGAAGTCGTTTCTATTTTGTTGGTTTTCGGAAATCGACTTAATGATTAATAGGGACAGTCGGGGGCATTTGTATTCAAACGACAGAGGTGAAATTCTTGGACCGTTTGAAGACAAACTACTGCGAAAGCATTTGCCAAGAATGTTT
ASV153	AGCTCCAATAGCGTATATTAAAGTTGTTGCAGTTAAAAAGCTCGTAGTTGGATTTCGGAGTGGGCCAGTTGGTCCGCCGCAAGGTGTGTTACTGACTGGTTTGCTCTGGTTTGCAGGCTATTGCTTGAATACATGAGCATGGAATAATGGAATAGGACTTTGGTCCCATTTTGTTGGTTTCTAGGGCCGAAGTAATGATTAAGAGGGACAATTGGGGGCATCCGTATTTCGTTGTCAGAGGTGAAATTCTTGGATTTACGAAAGACGAACAACTGCGAAAGCACTTGCCAAGAGTGTTT
ASV154	AGCTCCAATAGCGTATATTAAAGTTGTTGTGGTTAAAAAGCTCGTAGTTGGATCTCGGCGGTCTGAGGGCGGTTCACTTGCTAGTGCTACTGCCCTATAGACCGTAGTTTTGCCAGAGGTCTCAGGGTGCTCTTACGCCTGAATATTCGTGCATGGAATAATAGAATAGGAAGTCGTTTCTATTTTGTTGGTTTTCGGAAATCGACTTAATGATTAATAGGGACAGTCGGGGGCATTTGTATTCAAACGACAGAGGTGAAATTCTTGGACCGTTTGAAGACAAACTACTGCGAAAGCATTTGCCAAGAATGTTT
ASV155	AGCTCCAATAGCGTATATTAAAGCTGTTGTGGTTAAAAAGCTCGTAGTTGGATCTCGGCGGACTGAGGGCGGTTTGCTTGCTAGTATTACTGCCCTATTGTCCGTAGTTTTGCAAGAGTTTTTGGGGTACTCTTAATCGAATGTGTCAGGATGCTGGCAGATTTACTTTGAAAAAATTAGAGTGCTCAAAGCAGCCTATTACGCCTGAATATTCGTGCAAAAGGAACACTCGGGGGCATTTGTATTCAAACGACAGAGGTGAAATTCTTGGACCGTTTGAAGACAATCTACTGCAAAAGCATTTGCCAAGAATGTTT
ASV156	AGCTCCAATAGCGGCTCGGTCGGGGTTGCTCTTCATCGAGTGTCCCGGGCGGCCGGCATGTTTACTTTGAAAAATTAGGGTGCTCAGAGCAGGCCAAGGCGCCTGAATACTTGTGCATGGAATAATGGAATAGGACCTCGGTTCTATTTTGTTGGTTTTAAGAGCCCGAGGTAATGATTAACAGGAACAGACGGGGGCATCCGTATTGCGACGTTAGAGGTGAAATTCTTGGACCGTCGCAAGACGAACGACTGCGAAAGCATTTGCCAAGGATGTTT
ASV157	AGCTCCAATAGCGTATATTAAAGTTGTTGCGGTTAAAAAGCTCGTAGTTGGATCTCAGTTCCGGACCGACGGTACGCCGCCCGGCGTCTACTGTCGGCTTCCGAACGCTAAAGCCCGTCGGCTCGGTCGGGGTTGCGACGTTAGAGGTGAAATTCTTGGACCGTCGCAAGACGAACGACTGCGAAAGCATTTGCCAAGGATGTTTTCA
ASV158	AGCTCCAATAGCGTATATTAAAGTTGTTGCGGTTAAAAAGCTCGTCGGCTCGGTCGGGGTTGCTCTTCATCGAGTGTCCCGGGCGGCCGGCATGTTTATTTTGAAAAAAATTAGTGTGCTCAGAGCAGGCCAAGGCGCCTGAATACTTGTGCATGGAATAATGGAATAGGACCTCGGTTCTATTTTGTTGGTTTTAAGAGCCCGAGGTAATGATTAATAGGAACAGACGGGGGCATTCGTATTGCGACGTTAGAGGTGAAATTCTTGGATCGTCGCAAGACGAACTACTGCGAAAGCATTTGCCAAGAATGTTT
ASV159	AGCTAGTTTTGCCAGAGGTTCCTGGGTGCTCTTAATCGAGTGTCTAGGGATGCTGGCAGGTTTACTTTGAAAAAATTAGAGTGCTCAAAGCAGGCTATTACGCTTGAATATTCGTGCATGGAATAATAGAATAGGAAGTTGTTTCTATTTTGTTGGTTTTCGGAAATCGACTTAATGATTAATAGGGACAGTCGGGGGCATTTGTATTCAAACGACAGAGGTGAAATTCTTGGACCGTTTGAAGACAAACTACTGCGAAAGCATTTGCCAAGAATGTTT
ASV160	AGCTCCAATAGCGTATATTAAAGTTGTTGCAGTTAAAATCATTGATTGGTCGAGGGATTTACGACGTTTACTTTGAAAAAATTAGAGTGTTCAAAGCAGGCTATTGCTTGAATACATGAGCATGGAATAATGGAATAGGACCTTGGTCCCATTTTGTTGGTTTCTAGGACCGAGGTAATGATTAAGAGGGACAATTGGGGGCATCCGTATTTCGTTGTCAGAGGTGAAATTCTTGGATTTACGAAAGACGAACAACTGCGAAAGCACTTGCCAAGAGTGTTT
ASV161	AGCTCCAATAGCGTATATTAAAGTTGTGCTCTTAATCGAGTGTCTAGGGATGCTGGCAGGTTTACTTTGAAAAAATTAGAGTGCTCAAAGCAGGCTATTACGCTTGAATATTCGTGCATGGAATAATAGAATAGGAAGTTGTTTCTATTTTGTTGGTTTTCGGAAATCGACTTAATGATTAATAGGGACAGTCGGGGGCATTTGTATTCAAACGACAGAGGTGAAATTCTTGGACCGTTTGAAGACAAACTACTGCGAAAGCATTTGCCAAGAATGTTT
ASV162	AGCTCCAATAGCGTATATTAAAGTTGTTGCGGTTAAAAAGCTCGTAGTTGGATCTCGGCAAGTAGAGGGCGGTATGCTTCGTAGCATTACTGCCCTATTACTTGTAGTTTTGCCAGAGGTTCCTGGGTGCTCTTAATCGAGTGTCTAGGGATGCTGGCAGGTTTACTTTGAAAAAATTAGAGTGCTCAAAGCAGGCTATTACGCTTGAATATTCGTGCATGGAATAATAGAATAGGAAGTTGTTTCTATTTTGTTGGTTTTCGGAAGACAAACTACTGCGAAAGCATTTGCCAAGAATGTTT
ASV163	AGCTCCAATAGCGTATATTAAAGTTGTTGTGGTTAAAAAGCTCGTAGGCAGGTTTACTTTGAAAAAATTAGAGTGCTCAAAGCAGGCTATTACACCTGAATATTCGTGCATGGAATAATAGAATAGGAAGTCGTTTCTATTTTGTTGGTTTTCGGAAATCGACTTAATGATTAATAGGGACAGTCGGGGGCATTTGTATTCAAACGACAGAGGTGAAATTCTTGGACCGTTTGAAGACAAACTACTGCGAAAGCATTTGCCAAGAATGTTT
ASV164	AGCTCCAAAAGCGTATATTAAAGTTGTTGTGCTTAAAAAGCTAATTTTGCCAGAGGTTTCGGGGTGATCTTAATCAAGTGTCCCGGGATGCTGGCAGATTTACTTTGAAAAAATTAGAGTGCTCAAAGCAGGCTATTACGCCTGAATATTCGTGCATGGAATAATAGAATAGGAAGTCGTTTCTATTTTGTTGGTTTTCGGAAATCGACTTAATGATTAATAGGGACAGTCGGGGGCATTTGTATTCAAACGACAGAGGTGAAATTCTTGGACCGTTTGAAGACAAACTACTGCGAAAGCATTTGCCAAGAATGTTT
ASV165	AGCTCCAATAGCGTATATTAAAGTTGTTGTGGTTAAAAAGCTCGTAGTTGGATCTCGGCGGTCTGAGGGCGGTTCACTTGCTAGTGCTACTGCCCTATAGACCGTAGTTTTGCCAGAGGTGAAATTCTTGGACCGTTTGAAGACAAACTACTGCGAAAGCATTTGCCAAGAATGTTTTCA
ASV166	AGCTCCAATAGCGTATATTAAAGTTGTTGTGGTTAAAAAGCTCGTAGTTGGATCTCGGCGGACTGAGGGCGGTTTGCTTGCTAGTATTACTGCCCTATAGTCCGTAGTTTTGCCAGAGGTTTCGGGGTGCTTAATGATTAATAGGGGCAGTCGGGGGCATTTGTATTCAAACGACAGAGGTGAGATTCTTGGACCGTTTGAAGACAAACTACTGCGAAAGCATTTGCCAAGAATGTTTTCA
ASV167	AGCTCCAATAGCGTATATTAAAGTTGTTGCGGTTAAAAAGCTCGTAGTTGGATCTCGGCAAGTAGAGGGCGGTATGCTTCGTAGCATTACTGCCCTATTACTTGTAGTTTTGCCAGAGGTTCCTGGGTGCTCTTAATCGAGTGTCTAGGGATGCTGGCAGGTTTACTTTGAAAAAATTAGAGTGCTCGAAGCAGGCTATTACGCTTGAATATTCGTGCATGGAATAATAGAATAGGAAGTTGTTTCTATTTTGTTGGTTTTCGGAAATCGACTTAATGATTAATAGGGACA
ASV168	GTTGGTAAATCTCGTGCCAGCCACCGCGGTCACACGATTAACCCAAGTCAATAGAAGCCGGCGTAAAGAGTGTTTTAGGTCACCCCCTCCCCAATAAAGCTAAAACTCACCTGAGTTGTAAAAAACTCCAGTTGACACAAAATAGACTACGAAAGTGGCTTTAACATATCTGAACACACAATAGCTAAGACCCAAACTAGGATTAGATACCCCACTATG
ASV169	GTTGGTAAATCTCGTGCCAGCCACCGCGGCCATACGATTAACCCAAACTAATAGACCCACGGCGTAAAGCGTGTTACAGAGAAAAAATATACTAAAGTTAAATTTTAACTAGGCCGTAGAAAGCTACAGTTAACATAAAAATACAGCACGAAAGTAACTTTAACACCTCCGACTACACGACAGCTAAGACCCAAACTAGGATTAGATACCCCACTATG
ASV170	CTCGGTCCATTGTGGCACCCGCACGAGGCTGAGGTAGGCGCCCCCCAAGCCGGCACAGGCACCGCCGAACATGATCGCCAAAAGCCGGATACGGATTACCTTATAGCCTAGGGCATGGGCGGCATCATGGTTTTCGCCCACGTCACGTAAAATCAGCCCGGCTCGGCTGTATTTCTGCACAGCCCAGACCGCAAAGACCAGTGCAAGGCTGACATAGACCATCGGATCATGTGAAAACACGATCGGGCCCAAAACTGGAATATCGGACAGACCGGGGATATCAAGCGCCGGCAATGTTGGCGATTTCATCCCTTCATAGGGT
ASV171	AGCTCCAATAGCGTATATTAAAGTTGTTGTGGTTAAAAAGCTCGTAGTTCAAAGCAGGCTAAAATGCCTGAATATTCGTGCATGGAATAATAGAATAGGATGTCGATCCTATTTTGTTGGTTTTCGGGACTCGACATAATGATAAATAGGGACAGTCGGGGGCATTTGTATTCAAACGACAGAGGTGAAATTCTTGGACCGTTTGAAGACAAACTACTGCGAAAGCATTTGCCAAGAATGTTT
ASV172	AGCTCCAATAGCGTATATTAAAGTTGTTGTGGTTAAAAAGCTCGTAGTTGGATCTCGGCGGTCTGAGGGCGGTTCGCTTGCTTAAGCGCTACTGCCCTATAGGCCGTAGTTTTGCCAGAGGCCTCGGGGTGCTCTTAACCGAGTGTCCTGCGGCGCTGGCGGGTTTACTTTGAAAAAATTAGAGTGCTCAAAGCAGGCTTTTACGCCTGAATATTCGTGCATGGAATAATAGAATAGGAAGTCGTTTCTATTTTGTTGGTTTTCGGAAATCGACTTAATGATTAATAGGGACAG
ASV173	ACGTTTTTGACCTGAACGTTCTAATTGATATTTCATATCTCTGACAAGGTTTCTAAATGCAGTTCTAAACAAATCTGCAAGCATTTGTCCTGCAAATTTGATTACTTTATTTCCATAGTGATCTTTATCATCAGGAGTAATCCAACCAAGTTTTAATTCTAATAATTTACAAGCGGCTTCACCTAAGAATTGAGCTTTTTCTTTTCTATTTTCAGGATGTTTACCTAAGTGTGGCAATAAACC
ASV174	AGCTCCAATAGCGTATATTAAAGTTGTTGTGGTTGTGGTTGTGCTTTTGCTGGAGGTTTAGGGGTGCTCTTGATCGAGTGTCTCTGGATGCCAGCAGGTTTACTTTGAAAAAATTAGAGTGCTCAAAGCAGGCTAAAATGCCTGAATATTCGTGCATGGAATAATAGAATAGGATGTCGATCCTATTTTGTTGGTTTTCGGGACTCGACATAATGATAAATAGGGACAGTCGGGGGCATTTGTATTCAAACGACAGAGGTGAAATTCTTGGACCGTTTGAAGACAAACTACTGCGAAAGCATTTGCCAAGAATGTTT
ASV175	AGCTCCAACAGCGTATATTAAAGTTGCTGCAGTTAAAACGCTCGTAGTTGCTCCCCTGCTCGCCGCTCAGCACGCTGAGTGAAGAGCATCGCGGTGCATGTCGCCGCTAGCACTTTGAGGAAAGATCCGTATCCCACGCAAGTCTCTTTGTCTTCCGCAGCATGGTATGTTGTTCTCCGGGGAGGGGACCCGTCCGGCCTCTCCCCTTCCACACAGAAGTTCCGTGGGGTGTGCGTACTTTGATGTCAGAGGTGAAATTCCTAGATTTTCAAAAGACGAACAAGTGCGAAAGCATTAACCAGAAGATCGT
ASV176	AGCTCCAATAGCATATTTTTGTGCAGTTAAACTCGAAGTTAGATTTAAGGAGAGTGTCCTTTGCCAGCATGAAGTGTCCAGAGCGCTCTCCTTTCTTTGACAACTACAGCATTAACTTATGGACTGGTTTCAAACCCTGAAATAGAAGGTCAGGCAGGTTTCATAGCAGGAATAATGGAAAAGGACTTCAACCTCTTTGTTGGTCTGAGAGGCTGTAGAGCTGTAGTAATGATTAAAGGATAGTCTCACTGTCAGAGGTGAAATTCTTTGTTATTGAAGACATTAAAGACACTTAAGCAAAGCATTTGCCAAGGATGTTT
ASV177	AGCTCCAATAGCGTATATTAATGTTGCTGCAGTTAAAACGCTCGTAGTTGTTGTCCAACTATACGCCTCACTTCTTAGGAAGCTGTGGTTCGATAGTTTAGCGGGGATGACCTGCCAAAACCTTGAGGAAAGATTAGTGTTCCAAGCAATTAATTTTGACCTCTCAAGCATGGTATATAACCAAATAGAGGAAGATACTTGCCACATCTTCATCATACTAAATAGAAATTCAAGGGGGTATACGTACTTTAATGTCAGAGGTGAAATTCCTAGATTTTTAAGAGACGATCAAATGCGAAAGCATTCACCAAGCGACTTTTCC
ASV178	CCCTCAGGAATATCACGACCCAAGGTCAAGTTTTGTCGCACCGAATCAGCAAACAAAAACGTTTCCTGGAACACCGGCGCCACCACCGCCGCCGTGCCCTCCGAACCTAAATCTTGAACATCTACCCCACCCAACAACACCTGACCCTCGGTGGGTGGCATCAAAGCCGCCAACAAAGCTACCAAAGTACTTTTGCCAGCCCCCGTTGAACCCACCAAAGCCACCGTTTCTCCGGGA
ASV179	AGCTCCAATAGCGTATATTAAAGTTGTTGCGGTTAAAAAGCTCGTAGTTACTTTGAGGAAATCAGAGTGTTTCAAGCAGGCACACGCCTTGAATACATTAGCATGGAATAATAAGATAGGACCTTGGTTCTATTTTGTTGGTTTCTAGAGCTGAGGTAATGATTAATAGGGATAGTTGGGGGCATTCGTATTTAACTGTCAGAGGTGAAATTCTTGGATTTGTTAAAGACGGACTACTGCGAAAGCATTTGCCAAGGATGTTT
ASV180	ACGTTTTTGGCCTGAACGTTCTAATTGATATTTCATATCTCTGACAAGATTTCTAAATGCAGTTCTAAACAAATCTGCAAGCATTTGTCCTGCAGATTTGATTACTTTATTTCCATAGTGATCTTTGTCATCAGGGGTGATCCAACCAAGTTTTAATTCTAATAATTTACAAGCTGCTTCACCTAAGAATTGTGCTTTTTCTTTTCTATTTTCTTGCTGTTTACCTAAATGAGGTAATAGACC
ASV181	AAACCGGCAACAAATACTGAACGCCAAGCATCATCGCGGCGATCACCGCCACCGCTACCACACGCGAGTACGGCGAAAGCTCCGCGGCTAAGGGGGCGTCTCTCGTCGATTTTGACGACCTGATCGGTTGCACTGGGGCTGAATCACCAGACTTAATGACCTGAGCGAGCAACCCGTCCACGACGTAAAGCGCGATGAGCCCT
ASV182	AGCTCCAATAGCGTATATTAAAGTTGTTGCGGTTAAAAAGCTCGTAGTTGGATCTCGGCAAGTAGAGGGCGGTATGCTTCGTAGCATTACTGCCCTATTACTTGTAGTTTTGCCAGAGGTTCCTGGGTGCTCTTAATCGAGTGTCTAGGGTGTCTCAAACGACAGAGGTGAAATTCTTGGACCGTTTGAAGACAAACTACTGCGAAAGCATTTGCCAAGAATGTTTTCA
ASV183	AGCTCCAATAGCGTATATTAAAGTTGTTGCAGTTAAAAAGCTCGTAGTTGGATTTCGGAGTGGGCCAGTTGGTCCGCCGCAAGGTGTGTTACTGACTGGTTTGCTCTTCTTCGCAAAGACTGCGTGTGCTCTTGAGTGAGTGTGCGAAGGATTTACGACGTTTACTTTGAAAAAATTAGAGTGTTCAAAGCAGGCTATTGCTTGAATACATGAGCATGGAATAATGGAATAGGACTTTGGTCCCATTTTGTTGGTTTCTAGGGCCGAATTGGATTTACGAAAGACGAACAACTGCGAAAGCACTTGCCAAGAGTGTTT
ASV184	AGCTCCAATAGCGTATATTAAAGTTGTGTGGTTAAAAAGCTCGTAGTTGGAGGCCTCGGGGTGCTCTTAACCGAGTGTCCTGCGGCGCTGGCGGGTTTACTTTGAAAAAATTAGAGTGCTCAAAGCAGGCTTTTACGCCTGAATATTCGTGCATGGAATAATAGAATAGGAAGTCGTTTCTATTTTGTTGGTTTTCGGAAATCGACTTAATGATTAATAGGGACAGTCGGGGGCATTTGTATTCAAACGACAGAGGTGAAATTCTTGGACCGTTTGAAGACAAACTACTGCGAAAGCATTTGCCAAGAATGTTT
ASV185	AGCTCCAATAGCGTATATTAAAGTTGTTGCGGTTAAAAAGCTCGTAGTTGGATCGGGTGCTCTTAATCGAGTGTCTAGGGATGCTGGCAGGTTTACTTTGAAAAAATTAGAGTGCTCAAAGCAGGCTATTACGCTTGAATATTCGTGCATGGAATAATAGAATAGGAAGTTGTTTCTATTTTGTTGGTTTTCGGAAATCGACTTAATGATTAATAGGGACAGTCGGGGGCATTTGTATTCAAACGACAGAGGTGAAATTCTTGGACCGTTTGAAGACAAACTACTGCGAAAGCATTTGCCAAGAATGTTT
ASV186	AGCTCCAATAGCGTATATTAAAGTTGTTGCGGTTAAAAAGCTCGTAGTTGGATCTCGGCAAGTAGAGGGCGGTATGCTTCGTAGCATTACTGCCCTATTACTTGTAGTTTTGCCAGAGGTTCCTGGGTGCTCTTAATCGAGTGTCTAGGGATGCTGGCAGGTTTACTTTGAAAAAATTAGAGTGCTCATAGCAGGCTATTACGCTTGAATATTCGTGCATGGACAAACTACTGCGAAAGCATTTGCCAAGAATGTTTTCA
ASV187	AGCTCCAATAGCGTATATTAAAGTTGTTGCAGTTAAAAAGCTCGTAGTTGGATTTCGGAGTGGGCCAGTTGGTCCGCCGCAAGGTGTGTTACTGACTGGTTTGCTCTTCTTCGCAAAGACTGCGTGTGCTCTTGAGTGAGTGTGCGTAGGATTTACGACGTTTACTTTGAAAATATTAGAGTGTTCAAAGCAGGCTATTGCTTGAATACATGAGCATGGAATAATGGAATAGGACTTTGGTCCCATTTTGTTGGTTTCTAGGTGAAATTCTTGGATTTACGAAAGACGAACAACTGCGAAAGCACTTGCCAAGAGTGTTT
ASV188	AGCTCCAATAGCGGCTCGGTCGGGGTTGCTCTTCATCGAGTGTCCCGGGCGGCCGGCATGTTTACTTTGAAAAATTAGGGTGCTCAGAGCAGGCCAAGGCGCCTGAATACTTGTGCATGGAATAATGGAATAGGACCTCGGTTCTATTTTGTTGGTTTTAAGAGCCCGAGGTAATGATTAACAGGAACAGACGGGGGCATCCGTATTGCGACGTTAGAGGTGAAATTCTTGGACCGTCGCAAGACGAACTACTGCGAAAGCATTTGCCAAGAATGTTT
ASV189	AGCTCCAATAGCGTATATTAAAGTTGTTGTGGTTAAAAAGCTCGTAGTTGGATCTCGGCGGTCTGAGGGCGGTCTGAGGGCGGTTACTTTGAAAAAATTAGAGTGCTCAAAGCAGGCTTTTACGCCTGAATATTCGTGCATGGAATAATAGAATAGGAAGTCGTTTCTATTTTGTTGGTTTTTAAGTTTCGACTTAATGATTAATAGGGACAAACGGGGGCATTTGTATTCAAACGACAGAGGTGAAATTCTTGGACCGTTTGAAGACAAACTACTGCGAAAGCATTTGCCAAGAGTGTTT
ASV190	AGCTCCAAATCTTAATCGAGTGTCCCGGGATGCTGGCAGGTTTACTTTGAAAAAATTAGAGTGCTCAAAGCAGGCTATTACGCCTGAATATCCGTGCATGGAATAATAGAATAGGAAGTCGTTTCTATTTTGTTGGTTTTCGGAAATCGACTTAATGATTAATAGGGACAGTCGGGGGCATTTGTATTCAAACGACAGAGGTGAAATTCTTGGACCGTTTGAAGACAAACTACTGCGAAAGCATTTGCCAAGAATGTTT
ASV191	AGCTCCAATAGCGTATATTAAAGTTGTTGTGGTTAAAAAGCTCGTAGTTGGATCTCAGCAGTTTGAGGTTGGTGTACTTGCTAGTATTACTGCCCTATAGACTGTAGTTTTGCCAGAGGTAGTTGGGTGCTCTTAATCGAGTGTCCTATTATGCTGGCAGGTTTACTTTGAAAAAATTAGAGTGCTCAAAGCAGGCTATTACGCCTGAATTTTTCGTGCATGGAATAATAGAATAGGAAGTCGTTTCTATTTTGTTGGTTTTCGGAAATCGACTTAATGTTTGAAGACAAACTACTGCGAAAGCATTTGCCAAGAATGTTT
ASV192	AGCTCCATTAGTATATATCATTGTTGTTGTGGTTAAAAAGCTCGTAGTTGGATCTCTTCGAGTGTCTTGTGATGCTGGCAGGTTTACTTTGAAAAAATTAGAGTGCTCAAAGCAGGCTTTTACGCCTGAATATTCGTGCATGGAATAATAGAATAGGAAGTCGTTTCTATTTTGTTGGTTTTCGGAAATCGACTTAATGATTAATAGGGACAGTCGGGGGCATTTGTATTCAAACGACAGAGGTGAAATTCTTGGACCGTTTGAAGACAAACTACTGCGAAAGCATTTGCCAAGAATGTTT
ASV193	AGTAGTCTACTGTTGGCTTCCGAACGCTAAAGCCCGTCGGCTCGGTCGGGTGCTCTTCATCGAGTGTCCCGGGCGGCGGGCATGTTTTACTTTGAAAAAATTAGGGTGCTCAGAGCAGGCCAAGGCGCCTGAATACTTGTGCATGGAATAATGGAATAGGACCTCGGTTCTATTTTGTTGGTTTTAAGAGCCCGAGGTAATGATTAATAGGAACAGACGGGGGCATTCGTATTGCGACGTTAGAGGTGAAATTCTTGGATCGTCGCAAGACGAACTACTGCGAAAGCATTTGCCAAGAATGTTT
ASV194	AGCTCCAATAGCGTATATTAAAGTTGTTGCGGTTAAAAAGCTCGTAGTTGGATCTCAGTTCCGGACCGACGGTACGCCGCCCGGCGTCTACTGTCGGCTTCCGAACGCTAAAGCCCGTCGGCTCGGTCGGGGTGCTCTTCATCGAGAGTCCCGGGCGGCCGGCATGTTTACTTTGAAAAAATTAGGGTGCTTAGAGGAGGCCAAGGCGCCTGAATACTTGTGCATGGAATAATGGAATAGGACCTCGGTTCTATTTTGAAATTCTTGGATTGTTGCAAGACGAACTACTGCGAAAGCATTTGCCAAGAATGTTT
ASV195	AGCTCCAATAGCGTATATTAAAGTTGTTGCGGTTAAAAAGCTCGTAGTTGGATCTCGGCAAGTAGAGGGCGGTATGCTTCGTAGCATTACTGCCCTATTACTTGTAGTTTTGCCAGAGGTTCCTGGGTGCTCTTAATCGAGTGTCTAGGGATGCTGGCAGGTTTACTTTGAAAAAATTAGAGTGCTCAAAGCAGGCTATTACGCTTGAATATTCGTGCATGGAATAATAGAATAGGAAGTTGTTTCTATTTTGTTGGTTTTCGGAAATCGACTTAATGATTAATAGGGAAAGCATTTGCCAAGAATGTTT
ASV196	AGCTCCATTAGTATATATCATTGTTGTTGTGGTTAAAAAGCTCGTAGTTTGATCTCTTCGGTTTTAGATTGGTTCACTTTTTGGGTGCTACTGATCTATAGGCCGTACTTTTGTCAGAGGTCTCAGGGTGCTCTTAATCGAGTGTCTTGTGATGCTGGCAGGGACAGTCGGGGGCATTTGTATTCAAACGACAGAGGTGAAATTCTTGGACCGTTTGAAGACAATCTACTGCGAAAGCATTTGCCAAGAATGTTTTCA
ASV197	AGCTCCAATAGCGTATATTAAAGTTGTTGCGGTTAAAAAGCTCGTAGTTGGATCTCGGCAAGTAGAGGGCTCTTAATCGAGTGTCTAGGGATGCTGGCAGGTTTACTTTGAAAAAATTAGAGTGCTCAAAGCAGGCTATTACGCTTGAATATTCGTGCATGGAATAATAGAATAGGAAGTCGTTTCTATTTTGTTGGTTTTCGGAAATCGACTTAATGATTAATAGGGACAGTCGGGGGCATTTGTATTCAAACGACAGAGGTGAAATTCTTGGACCGTTTGAAGACAAACTACTGCGAAAGCATTTGCCAAGAATGTTT
ASV198	AGCTCCAATAGCGTATATTAGTCCGTAGTTTTGCCAGAGGTTTCGGGGTGCTCTTAATCGAGTGTCCCGGGATGCTGGCAGGTTTACTTTGAAAAAATTAGAGTGCTCAAAGCAGGCTATTACGCCTGAATATTCGTGCATGGAATAATAGAATAGGAAGTCGTTTCTATTTTGTTGGTTTTCGGAAATCGACTTAATGATTAATAGGGACAGTCGGGGGCATTTGTATTCAAACGACAGAGGTGAAATTCTTGGACCGTTTGAAGACAAACTACTGCGAAAGCATTTGCCAAGAATGTTT
ASV199	AGCTCCGATAGCGTATATTAGAGTCGTTGTGATTAAAAAGCTCGTCTGAATATTTGTGCATGGAATAATAGGATAGGAAGTTGTTTCTATTTTGTTGGTTTTCAGAAATCGACTTAATGATTAACAGGGACACTCGGGGGCATTTGTATTCAAACGACAAAGGTGAAATTCTTGGACCGTTTGAAGACAAACTACTTTGAAAGCCTTTGCCAAGAATATTTTCA
ASV200	AGCTCCAATGGGTGCTCTTAATCGAGTGTCTAGGGATGCTGGCAGGTTTACTTTGAAAAAATTAGAGTGCTCAAAGCAGGCTATTACGCTTGAATATTCGTGCATGGAATAATAGAATAGGAAGTTGTTTCTATTTTGTTGGTTTTCGGAAATCGACTTAATGATTAATAGGGACAGTCGGGGGCATTTGTATTCAAACGACAGAGGTGAAATTCTTGGACCGTTTGAAGACAAACTACTGCGAAAGCATTTGCCAAGAATGTTT
ASV201	AGCTCCAATAGCGTATATTAAAGTTGTTGTGGTTAAAAAGCTCGTAGTTGGATCTCGGCGGACTGAGGGCGGTTTGCTTGCTAGTATTACTGCCCTATAGTCCGTAGTTTTGCCAGAGGTTCCTGGGTGCTCTTAATCGAGTGTCTAGGGATGCTGGCAGGTTTACTTTGAAAAAATTAGAGTGCTCAAAGCAGGCTATTACGCTTGAATATTCGTGCATGGAATAATAGAATAGGAAGTTGTTTCTATTTTGTTGGACCGTTTGAAGACAAACTACTGCGAAAGCATTTGCCAAGAATGTTT
ASV202	AGCTCCAATAGCGTATATTAAAGTTGTTGCAGTTAAAAAGCTCGTAGTTGGATTTCGGAGTGGGCCAGTTGGTCCGCCGCAAGGTGTGTTACTGACTGGTTTGCTCTTCTTCGCAAAGACTGCGTGTGCTCTTTATTGAGTGTGCGTAGGATTTACGACGTTTACTTTGAAAAAATTAGAGTGTTCAAAGCAGGCTATTGCTTGAATACATGAGCATGGAATAATGGATTTACGAAAGACGAACAACTGCGAAAGCACTCGCCAAGAGTGTTT
ASV203	AGCTCCAATAGCGTATATTAAAGTTGTTGCAGTTAAAAAGCTCGTAGTTGGATTTCGGAGTGGGCCAATTTTGAAAAAATTAGAGTGTTCAAAGCAGGCTATTGCTTGAATACATGAGCATGGAATAATGGAATAGGACTTTGGTCCCATTTTGTTGGTTTCTAGGACCGAAGTAATGATTAAGAGGGACAATTGGGGGCATCCGTATTTCGTTGTCAGAGGTGAAATTCTTGGATTTACGAAAGACGAACAACTGCGAAAGCACTTGCCAAGAGTGTTT
ASV204	AGCTCCAATAGCGTATATTAAAGTTGTTGTGGTTAAAAAGCTCGTAGTTGGATCTCGGCGGACTGAGGGCGGTTTGCTTGCTAGTATTACTGCCCTATAGTCCGTAGTTTTGCCAGAGGTTTCGGGGTGCTCTTAATCGAGTGTCTAGGGATGCTGGCAGGTTTACTTTGAAAAAATTAGAGTGCTCAAAGCAGGCTATTACGCTTGAATATTCGTGCATGGAATAATAGAATAGGAAGTTGTTTCTATTTTGTTGGTTTTCGGAAATCGACTTAATGATTAATAGGGACAGTCGGGGGCATTTGCCAAGAATGTTT
ASV205	AGCTCCAATAGCGTATATTAAAGTTGTTGTGGTTAAAAAGCTCGTAGTTGGATCTCAGTTCCGGACCGACGGTACGCCGCCCAGCGTCTACTGTCGGCTTCCGAACGCTAAAGCCCGTCGTGCTCAGAGCAGGCCAAGGTGCCTGAATACTTACTTGTGCATGGAATAATGGAATAGGACCTCGGTTCTATTTTGTTGGTTTTAAGAGCCCGAGGTAATGATTAATAGGAACAGACGGGGGCATTCGTATTGCGACGTTAGAGGTGAAATTCTTGGATCGTCGCAAGACGAACTACTGCGAAAGCATTTGCCAAGAATGTTT
ASV206	AGCTCCAATAGCGTATATTAAAGTTGTTGTGGTTAAAAAGCTCGTAGTTGGATCTCGGCGGACTGAGGGCGGTTTGCTTGCTAGTATTACTGCCCTATAGTCCGTATTACTGCCCTATAGTCCGTATTCAAACGACAGAGGTGAAATTCTTGGACCGTTTGAAGACAAACTACTGCGAAAGCATTTGCCAAGAATGTTTTCA
ASV207	AGCTCCAATAGCGTATATTAAAGTTGTTGTGGTTAAAAAGCTCGTAGTTGGATCTCTGTTTGCCCACAGTGGTTTTTACGGGTAACGGGTATAATAGAATAGGAAGTCGTTTCTATTTTGTTGGTTTTCGGAAATCGACTTAATGATTAATAGGGACAGTCGGGGGCATTTGTATTCAAACGACAGAGGTGAAATTCTTGGACCGTTTGAAGACAAACTACTGCGAAAGCATTTGCCAAGAATGTTTTCATCAATCAAGACAAGT
ASV208	AGTTCCAATAGTTGTTATATTATAGCTGTTGTGGTTAAAAAGCTCGTAGTTGGATCTCGGCGGACTGAGGGCGGTTTGCTTGCTAGTATTACTGCCCTATTGTCCGTAGTTTGGCAAGAGTTTTTGGGGTACTCTTAATCGAATGTGTCAGGATGCTGGCAGATTTACTTTGAAAAAATTAGAGTGCTCAAAGCAGCCTATTACGCCTGAATATTCGTGCAAAAGGAACACTCGGGGGCATTTGTATTCAAACGACAGAGGTGAAATTCTTGGACCGTTTGAAGACAATCTACTGCAAAAGCATTTGCCAAGAATGTTT
ASV209	AGCTCCAATAGCGTATATTAAAGTTGTTGCGGTTAAAAAGCTCGTAGTTGGATCTCAGTTCCGGACCGACGGTACGCCGCCCGGCGTCTACATTCGGCTTCCGAACGCTAAAGCCCGTCGGCTCAGAGCAGGCCAAGGTGCCTGAAAACTTTTGCATGGAATAATGGAATAGGACCTCGGTTCTATTTTGTTGGTTTTAAGAGCCCGAGGTAATGATTAACAGGAACAGACGGGGGCATCCGTATTGCGACGTTAGAGGTGAAATTCTTGGACCGTCGCAAGACGAACTACTGCGAAAGCATTTGCCAAGAATGTTT
ASV210	AGCTCCAATAGCGTATATTAAAGTTGTTGCGGTTAAAAAGCTCGTAGTTGGATCTCGGCGGGCAGGGGGTGGTTCGCTCTTCAGCGCTACTGCCCCGCTTTGCCCGTGTGATTGGCGGAGGTTTCGGGGTGCTCTTCGTTGAGTGACAATTGGGGGCATTAGTATTCAGACGACAGAGGTGAAATTCTTGGACCGTCTGAAGACTGACTACTGCGAAAGCATTTGCCAAGAGTGTTTTCA
ASV211	AGCTCCAGTAGCGTATATTAAAGTTGTTGTGGTTAAAAAGCTCGTAGTTGGATCTCAACAGCCTTGAAGCGGTTAACTTTGTAGTTTTACTGCTTTATAGGCTGTGCTTTTGCTGCTTAAAGCAGGCTAAGATGCCTGAATATTCGTGCATGGAATAATAGAATAGGATGTCGATCCTATTTTGTTGGTTTTCGGGACTCGACATAATGATAAATAGGGACAGTCGGGGGCATTTGTATTCAAACGACAGAGGTGAAATTCTTGGACCGTTTGAAGACAAACTACTGCGAAAGCATTTGCCAAGAATGTTT
ASV212	ATTAGTTACTTTGAAAAAATCAAAGTGATTAACACAAGCTATCGCTTGAATATTTGTGCATGGGATAACGAAACAAGACTGTTAGCGAATCAGTTGGTTGAATCGCTAAAAGTAATGATAAATAGAGACTGTCGGGGGCATTTGTATTTGTAAGCGAGAGGTGAAATTCATTGACCTTACAAAGACAAACCAAAGCGAAAGCATTTGCCAAGAATGTCT
ASV213	GTTGGTAAATCTCGTGCCAGCCACCGCGGTCATACGAGTAACTCACATTAATACTTCACGGCGTAAAGGGTGATTAAAAGTTTCTAAAAAGTACTAGAGTTATAACCTTATAAAGCTGTCACACGCACCTATAAAAGGAACAATACACTGACGAAAGTAACTTTAACAATTTAGAGCTTTTGACCTCACGACAGTTAAGACACAAACTAGGATTAGGTACCCCACTATG
ASV214	AGCTCCAATAGCGTATATTAAAGTTGTTGTGGTTAAAAAGCTCGTAGTTGGATCTCAACAGCCTTGAAGCGGTTAACTTTGTAGTTTTACTGCTTTATAGGCTGTGCTTTTGCTGGAGGTTTAGGGGTGCTCTTGATCGAGTGTCTCTGGATGCCAGCAGGTTTACTTTGAAAAAATTAGAGTGCTCAAAGCAGGCTAAAATGCCTGTCAGAGGTGAAATTCTTGGACCGTTTGAAGACAAACTACTGCGAAAGCATTTGCCAAGAATGTTT
ASV215	AGCTCCAATAGCGTATATTAAAGTTGTTGTGGTTAAAAAGCTCGTAGTTGGATCTCGGCGGTCTGAGGGCGGTTCGCTTCAGAGCGCTGGCAGGTTTACTTTGAAAAAATTAGAGTGCTCAAAGCAGGCTTTTACGCCTGAATATTCGTGCATGGAATAATAGAATAGGAAGTCGTTTCTATTTTGTTGGTTTTCGGAAATCGACTTAATGATTAATAGGGACAGTCGGGGGCATTTGTATTCAAACGACAGAGGTGAAATTCTTGGACCGTTTGAAGACAAACTACTGCGAAAGCATTTGCCAAGAATGTTT
ASV216	AACGCCGACTAATAAACCAGCAAAGATAATTAATGGAAAAGAATCTGTAATTAAAAATGGAATTTCATCATTAATAAATATACTAAATATGATTGGCCCAATTACTAAACCTATAATAAATAAAAAATTATCTATTCTATTAATTTTTGATAAAATAAAATTATTAGCAATGCCACTAACTCCTGCCAATTTACCATTTCCAATAAAATACAATGCAACAGCAAGACCAATTATTATTCCA
ASV217	AGCTCCAATAGCGTATATTAAAGTTGTTGCAGTTAAAAAGCTCGTAGTTGGATTTCAAGAGACGCAACGTGGACACACGTCTGCCCTCTACCAGTCTTTGACTGTTACTGTGAGAAAATTAGAGTGTTTCAAGCAGGCTGTTGCAGGAATACATTAGCATGGAATAACGAATGGGTCTAGAATCTTGGTTAATTCTAGATTACGATTAATAGGGACAGTTGGGGGCATTAGTATTTAATTGTCAGAGGTGAAATTCTTGGATTTATTAAAGACTAACGTATGCGAAAGCATTTGCCAAGGATGTTT
ASV218	CAGCGGCCTCGGCGCAGTTGCCGCTGCTATATCAATATTCCCCTGATCTATTCGCAAAAGCGGTGCGTTCTCGCAGGTGCAGCCGCCTTGCATAGCAGTCGAAACCATGACGCACGGCATTGAGGCAGCAATACGCTCATCGATAGCGCCAAGAATCATCGCCTGCGTGCCACCGCCACTGGCTCCAGTTACACCCACCCGAGTTGGATCGACGTCATCCAACTGCAATACGAAATCAACAGCC
ASV219	GGCGGATCGTGCCCCATCTCATGTTTTGCATACTCACTCTGCATACAGATCAAATCGCGGCAATCATCAGGATTCGAGTAATCAACTCGCTTGGTGGTGATTTGCATACTTTGCATTCTTACTTATTAGATATAGGCTTTCTCAAAGCTACCAGCGTAAAAGAAATATCACTCAGAAAGTAGGATACGCCGCTATAATTTGACCAAACCACCAATCCGTTCAACCTACGCTTCCGCCTCCTCTGTGTACTCGATGATTTATTTAAGA
ASV220	AGCTCCAATAGCGTATATTAAAGTTGTTGTTGAGTGTCTCTGGATGCCAGCAGGTTTACTTTGAAAAAATTAGAGTGCTCAAAGCAGGCTAAAATGCCTGAATATTCGTGCATGGAATAATAGAATAGGATGTCGATCCTATTTTGTTGGTTTTCGGGACTCGACATAATGATAAATAGGGACAGTCGGGGGCATTTGTATTCAAACGACAGAGGTGAAATTCTTGGACCGTTTGAAGACAAACTACTGCGAAAGCATTTGCCAAGAATGTTT
ASV221	AGCTCCAATAGCGTATATTAAAGTTGTTGTGGTTAAAAAGCTCGTAGTTGGATCTCAACAGCCTTGAAGCGGTTAACTTTGTAGTTTTACTGCTTTATAGGCTGTGCTTTTGCTGGAGGTTTAGGGGTGCTCTTGATCGAGTGTCTCTGGATGCCAGCAGGTTTACTTTGAAAAAATTAGAGTGCTCAAAGCAGGCTAAAATGCCTGAATATTCGTGCATGGAATAATAGAATAGGATGTCGATCCTATTTTGTTGGTTTTCGGGACTCGACATAATGATAAATAGGGACAGTCGGGGGCGAAAGCATTTGCCAAGAATGTTT
ASV222	AGCTCCAATAGCGTATATTAAAGTTGTTGCAGTTAAAAAGCTCGTAGTTGGATTTCAAGAAACGCTCCGGGATAACCGGTAGCTTTCTACCAGTCTTTGACTGTTACTGTGAGAAAATTAGAGTGTTTCAAGCAGGCTTTGCAGGAATACATTAGCATGGAATAACGCGTGTGTCTACAATTTGGTTGATTGTAGATTACGATTAATAGGGACAGTTGGGGGCATTAGTATTTAATAGTCAGAGGTGAAATTCTTGGATTTGTTAAAGACTAACGTATGCGAAAGCATTTGCCAAGGATGTTT
ASV223	TTTCGGCGGAAACATCATTACTGATGACATCAAGGAGGGCTGCATCATCATCAAGAAGCAAGCTGAATTATTGAAGGTCAAGTTTGGTTCAGCGCTTGCCCGAGAAAATCAAGCGAATGACATCGTTGTCATTCCTGGTTTAAGTGGTCGCGAGCCCAAAGAAATAAGTGTAAAGAACTTAGCACACA
ASV224	AGCTCCAATAGCGTATATTAAAGTTGTTGCAGTTAAAAAGCTCGTAGTTGGATTTCAAGAGACGCAACGTGGACACACGTCTGCCCTCTACCAGTCTTTGACTGTTACTGTGAGAAAATTAGAGTGTTTCAAGCAGGCTGTTGCAGGAATACATTAGCATGGAATAACGAATGGGTCTAGAATCTTGGTTAATTCTAGATTACGATTAATAGGGACAGTTGGGGGCATTAGTATTTAATTGTCAGAGGTGAAATTCTTGGATTTATTAAAGACTAACGTATACGAAAGCATTTGCCAAGGATGTTT
ASV225	AGCTCCAATAGCGTATATTAAAGTTGTTGCAGTTAAAAAGCTCGTAGTTGGATTTCTGGCAGTGTAACTCCGGCCGGCATGACGTCGGGCCCGGAGCGCGCTACCATCCTTCTGTCAACCTTCGCGAAATTTATTTCGTTGCATTGTGAGCTCAAATATTTTACCTTGAGAAAATTAGAGTGTTTCAGACATGCTTTCGCCGGAATACATTAGCATGGAATAATGGAAAAGGACTTCAACCTCTTCTGTTGGTCTGGTTATGTCATTTGCCAAGGATGTTT
ASV226	ACGTTTTTGACCTGAACGTTCTAATTGATATTTCATATCTCTAACTAAATTTCTAAATGCAGTTCTAAACAAATCTGCAAGCATTTGTCCTGCAAATTTGATTACTTTGATTCCATAATGATCTTTGTCATCAGGAGTAATCCAACCAAGCTTTAATTCTAATAATTTACAAGCTGCTTCACCTAAGAGTTGTGCTTTTTCTTTTCTATTTTCAGGATGTTTACCCAAATGAGGCAATAGACC
ASV227	AAAATATCCCGCCTGAGCAACCAGTATATCAATGGGTTTTTCAAACTGGTTAAAGTTGAATTCCTGAGGCACAACACCTACAAATTGTTCTGCAGTTGAAAAATCCTCATCAACATCATGACCGAAGATAGTCACAGTCCCAGAAGTCTTTCGGACCAATGAACAAATAATACCAATTGTCGTTGATTTACCCGCTCCGTTTGGC
ASV228	ACGTTTTTGTCCTGATCTTTCTAATTGATATTTCATATCTCTAACAAGATTTCTAAATGCAGTTCTAAACAGATCTGCCAACATTTGTCCTGCAAATTTGATTACTTTGTTTCCATAATGATCTTTATCATCAGGTTTAATCCAACCAAGTTTTAATTCTAATAATTTACAAGCAGCCTCTCCCAAAAATTGAGCTTTTTCTTTTCTATTTTCAGGATGTTTTCCTAAGTGAGGTAACAAACC
ASV229	CAACCAAGCTCAGTAACGAAAGTGAAGTCGTCCGAAAGTGTCCAACGAAGTCGATCCACCAACGATCGAAGCGCGCGCCCCAATCCAAAGTCTGCAACCTGTCGTTTCGCTGCATCCCAGATCAAGAATAAAGCTGGTCTCATCTCAGGCCTGAACCAAAGCTGCTCCCAGAGGTGAAGTAGCAGACTCCACTCCTTCCTTGCCTG
ASV230	CATTTTGGATTCGGAGTCCGCTTCTTGAACAGCAATTACTTCGAGTTTCTTTGCAAGCGCTTTTCCAGCGATAGCATTTGATTCTCTCTTTTGAACTTCGATTTCTCGATTCGAATCTGCTTGTGCTACTTGTATTTGTCCCATCTCAAGTGCTTTTGCTCGGTCACCCGTAGCACCAGCAATTGCTTCAGCAGCTGCTTTAGCA
ASV231	AGCTCCAATAGCGTATATTAAAGTTGTTGCGGTTAAAAAGCTCGTAGTTGGATCTCGGCAAGTAGAGGGCGGTATGCTTCGTAGCATTACTGCCCTATTACTTGTAGTTTTGCCAGAGGTTCCTGGGTGCTCTTAATCGAGTGTCTAGGGATGCTGGCAGGTTTACTTTGAAAAAATTAGAGTGCTCAAAGCAGGCTATTACGCTTGAATATTCGTGCATGGAATAATAGAATAGGAAGTTGTTTCTATTTTGTTGGTTTTCGGAAATCGACTTAATGATTAATAGGGACAGTCAAGAACATTCTTTGCCAAGAATGTTT
ASV232	AGCACCAATAGTGTATTTTAATGTTGTTGCTGTTAAAAAGCTCGTAGTTGATCTTCGGCCGCAAGGTCTGTCCCACTCTTCGTGAGAGGGCAATTACTGTGAAGAAATCAAAGTGCTCAAGGCAAGCTCAGCTTGTATACTTCAGCATGGAATAATGCAAAATGACTCCTTCATATCATTGGTGGAACGGAGTAATGATTAATAGGAACAGTTGGGGACATTCGTATTTAATTATCAGAGGTGGAATTCATAGATTTTTTAAAGACGAACAGAAGCGAAGGCGTTTGTCAAGGATGCTT
ASV233	AGCTCCATTAGTATAGGCCGTACTTTTGTCAGAGGTCTCAGGGTGCTCTTAATCGAGTGTCTTGTGATGCTGGCAGGTTTACTTTGAAAAAATTAGAGTGCTCAAAGCAGGCTTTTACGCCTGAATATTCGTGCATGGAATAATAGAATAGGAAGTCGTTTCTATTTTGTTGGTTTTCGGAAATCGACTTAATGATTAATAGGGACAGTCGGGGGCATTTGTATTCAAACGACAGAGGTGAAATTCTTGGACCGTTTGAAGACAAACTACTGCGAAAGCATTTGCCAAGAATGTTT
ASV234	AGCTCCAATAGCGTATATTAAAGTTGTTGTGGTTAAAAAGCTCGTAGTTGGATCTCGGCGGTCTGAGGGCGGTTCGCTTCAGAGTGCTCAAAGCAGGCTTTTACGCCTGAATATTCGTGCATGGAATAATAGAATAGGAAGTCGTTTCTATTTTGTTGGTTTTCGGAAATCGACTTAATGATTAATAGGGACAGTCGGGGGCATTTGTATTCAAACGACAGAGGTGAAATTCTTGGACCGTTTGAAGACAAACTACTGCGAAAGCATTTGCCAAGAATGTTT
ASV235	AGCTCCGAGTGTCTTGCGATGCTGGCAGGTTTACTTTGAAAAAATTAGAGTGCTCAAAGCAGGCTTTTACGCCTGAATATTCGTGCATGGAATAATAGAATAGGAAGTCGTTTCTATTTTGTTGGTTTTCGGAAATCGACTTAATGATTAATAGGGACAGTCGGGGGCATTTGTATTCAAACGACAGAGGTGAAATTCTTGGACCGTTTGAAGACAAACTACTGCGAAAGCATTTGCCAAGAATGTTT
ASV236	GTTGGTAAATCTCGTGCCAGCCACCGCGGTCATACGATTAACCCAAACTAATAGGCCCTCGGCGTAAAGCGTGTTAAAGATCAACCCACACTAAAGCTAAAACCTAACCAAGCCGTAAAAAGCTACCGTTAACATAAAATCAGACCACGAAAGTGACTTTACTAATTCTGACTGCACGATAGCTAAGATCCAAACTAGGATTAGATACCCCACTATG
ASV237	AGCTCCAATAGCGTATATTAAAGTTGTTGTGGTTAAAAAGCTCGTAGTTGGATCTCGGCGGACTGAGGGCGGTTTGCTTGCTAGTATTACTGCCCTATAGTCCGTAGTTTTGCCAGAGGTTTCGGGGTGCTCTTAATCGAGTGTCCCGGGATGCTGGCAGGTTTACTTTGAAAAAATTAGAGTGCTCAAAGCAGGCTATTACGCGACTTAATGATTAATAGGGACAGTCGGGGGCATTTGTATTCAAACGACAGAAGTGAAATTCTTGGACCGTTTGAAGACAAACTACTGCGAAAGCATTTGCCAAGAATGTTT
ASV238	AGCTCCACTAGCATATATTAAAGTTGTTGCGGTTAAACAGCTCGTAGTTGGATCTTCATCGAGTGTCCCGGGCGGCCGGCACGTTTACTTTGAAAAAATTAGGGTGCTCAGAGCAGGCCAAGGCGCCTGAATACTTGTGCATGGAATAATGGAATAGGACCTCGGTTCTATTTTGTTGGTTTTAAGAGCCCGAGGTAATGATTAATAGGAACAGACGGGGGCATTCGTATTGCGACGTTAGAGGTGAAATTCTTGGATCGTCGCAAGACGAACTACTGCGAAAGCATTTGCCAAGAATGTTT
ASV239	AGCTCCAATAGCGTATATTAAAGTTGTTGCAGTTAAAAAGCTCGTAGTTGGATTTCGGAGTGGGCCAGTTGGTCCGCCGCTTGAATACATGAGCATGGAATAATGGAATAGGACCTTGGTCCCATTTTGTTGGTTTCTAGGACCGAGGTAATGATTAAGAGGGACAATTGGGGGCATCCGTATTTCGTTGTCAGAGGTGAAATTCTTGGATTTACGAAAGACGAACAACTGCGAAAGCACTTGCCAAGAGTGTTT
ASV240	AGCTCCAATAGCGTATATTAAAGTTGTTGCGGTTAAAAAGCTCGTAGTTGGATCTCGGCAAGTAGAGGGCGGTATGCTTCGTAGTATTACTGCCCTATAGTCCGTAGTTTTGCCAGAGGTTTCGGGGTGCTCTTAATCGAGTGTCCCGGGATGCTGGCAGGTTTACTTTGAAAAAATTAGAGTGCTCAAAGCAGGCTATTACGCGACTTAATGATTAATAGGGACAGTCGGGGGCATTTGTATTCAAACGACAGAAGTGAAATTCTTGGACCGTTTGAAGACAAACTACTGCGAAAGCATTTGCCAAGAATGTTT
ASV241	AGCTCCAATAGCGTATGTTAAAGTTGTTGCGGTTAAAAAGCTCGTAGTTGGATCTCAGTTCCGGACCGACGGTACGCCGCTTGGCGTCTACTGTCGGCTTCCTCAGTGTCCCGGGCGGCCGGCACGTTTACTTTGAAAAAATTAGGGTGCTCAGAGCAGGCCAAGGCGCCTGAATACTTGTGCATGGAATAATGGTTTTAAGAGCCCGAGGTAATGATTAACAGGAACAGACGGGGGCATCCGTATTGCGACGTTAGAGGTGAAATTCTTGGACCGTCGCAAGACGAACTACTGCGAAAGCATTTGCCAAGAATGTCT
ASV242	AGCTCCAATAGCGTATATTAAAGTTGTTGTGGTTAAAAAGCTCGTAGAAAAAATTAGAGTGCTCAAAGCAGGCTATTACGCCTGAATATTCGTGCATGGAATAATAGAATAGGAAGTCGTTTCTATTTTGTTGGTTTTTAAGTTTCGACTTAATGATTAATAGGGACAAACGGGGGCATTTGTATTCAAACGACAGAGGTGAAATTCTTGGACCGTTTGAAGACAAACTACTGCGAAAGCATTTGCCAAGAGTGTTT
ASV243	AGGGCGGTTTGCTTGCTAGTATTACTGCCCTATAGTCCGTAGTTTTGCCAGAGGTTTCGGGGTGCTCTTAATCGAGTGTCCCGGGATGCTGGCAGGTTTACTTTGAAAAAATTAGAGTGCTCAACGCAGGCTATTACGCCTGAATATTCGTGCATGGAATAATAGAATAGGAAGTCGTTTCTATTTTGTTGGTTTTCGGAAATCGACTTAATGATTAATAGGGACAGTCGGGGGCATTTGTATTCAAACGACAGAGGTGAAATTCTTGGACCGTTTGAAGACAAACTACTGCGAAAGCATTTGCCAAGAATGTTT
ASV244	AGCTCCAATAGCGTATATTAAAGTTGTTGTGGTTAAAAAGCTCGTAGTTTTGCCAGAGGTCTCAGGGTGCTCTTAATCGAGTGTCTTGCGATGCTGGCAGGTTTACTTTGAAAAAATTAGAGTGCTCAAAGCAGGCTTTTACGCCTGAATATTCGTGCATGGAATAATAGAATAGGAAGTCGTTTCTATTTTGTTGGTTTTCGGAAATCGACTTAATGATTAATAGGGACAGTCGGGGGCATTTGTATTCAAACGACAGAGGTGAAATTCTTGGACCGTTTGAAGACAAACTACTGCGAAAGCATTTGCCAAGAATGTTT
ASV245	ACCGCCATCGCCGCCTAAAATCACCAAAATGTACACTAAAACTGAATTGATCGGATTAAACAAACGGGGATTAATCAACCGCGCCACCTGCCGCGCAGCACACTTGCTGCATGATTACCGATTCTCGCTTCTCGTAGGTAGACTTCATTGTCGCACAATTTTCTACTTCCCCACCCAAAATTATTATGTGTTTGACCGTGAATATTTGTTGTTTCGTGGATC
ASV246	AGCTCCAATAGCGTATATTAAAGTTGTTGCGGTTAAAAAGCTCGTCGGGGTTGCTCTTCATCGAGTGTCCCGGGCGGCCGGCATGTTTACTTTGAAAAAATTAGGGTGCTCAGAGCAGGCCAAGGTGCCTGAATACTTGTGCATGGAATAATGGAATAGGACCTCGGTTCTATTTTGTTGGTTTTAAGAGCCCGAGGTAATGATTAACAGGAACAGACGGGGGCATCCGTATTGCGACGTTAGAGGTGAAATTCTTGGACCGTCGCAAGACGAACGACTGCGAAAGCATTTGCCAAGGATGTTT
ASV247	AGCTCCAATAGCGTATATTAAAGTTGTTGTGGTTAAAAAGCTCGTAGTTGGATCTCGGCGGTCTGAGGGCGGTTCGCTTCAGGCTTTTACGCCTGAATATTCGTGCATGGAATAATAGAATAGGAAGTCGTTTCTATTTTGTTGGTTTTCGGAAATCGACTTAATGATTAATAGGGACAGTCGGGGGCATTTGTATTCAAACGACAGAGGTGAAATTCTTGGACCGTTTGAAGACAAACTACTGCGAAAGCATTTGCCAAGAATGTTT
ASV248	AGCTCCAATAGCGTATATTAAAGTTGTTGCGGTTAAAAAGCTCGTAGTTGGATCTCAGTTCCGGACCGACGGTACGCCACCCAGCGTCTACTGTCTGCTTCCAAACTTTGAAAAAATGAGGGTGCTCAGAGCAGGCCAAGGCACCTGAAAACTTGTGCATGGAATAATGGAATAGGACCTCGGTTCTATTTTGTTGGTTTTAAGAGCCCGAGGTAATGATTAACAGGAACAGACGGGGGCATCCGTATTGCGACGTTAGAGGTGAAATTCTTGGACCGTCGCAAGACGAACTACTGCGAAAGCATTTGCCAAGAATGTTT
ASV249	AGCTCCAATAACATATATTAAAGTTGTTGTGGTTAAAAAGCTCATAGATGGATCTCAGTTCCAGACCCACGGTACGCCGCCCAGCTTCTACTGTCTGCTTCCAAACTTTGAAAAAATTAGAGTGCTCAAAGCAGGCTTTTACGCCTGAATATTCGTGCATGGAATAATAGAATAGGAAGTCGTTTCTATTTTGTTGGTTTTCGGAAATCGACTTAATGATTAATAGGGACAGTCGGGGGCATTTGTATTCAAACGACAGAGGTGAAATTCTTGGACCGTTTGAAGACAAACTACTGCGAAAGCATTTGCCAAGAATGTTT
ASV250	AGCACCTGTTGTAAGAAACCACATACTTATAAACTGAATCTTTATAGAATTTTTTTTCAGTTATTAATTTTCAGTATGGTAAAAGAAAGTTTATGCATTATTACATCTTAATACCAGTATAGCGCATCGGATTTAAAATCCAATCCGAAGAACGAGTGAGCCTACACACATACACAAA
ASV251	AGCTCCAATAGCGGCTCGGTCGGGGTTGCTCTTCATCGAGTGTCCCGGGCGGCCGGCATGTTTACTTTGAAAAATTAGAGTGCTCAGAGCAGGCCAAGGCGCCTAAATACTTGTGCATGGAATAATGGAATAGGACCTCGGTTCTATTTTGTTGGTTTTAAGAGCCCGAGGTAATGATTAACAGGAACAGACGGGGGCATCCGTATTGCGACGTTAGAGGTGAAATTCTTGGACCGTCGCAAGACGAACGACTGCGAAAGCATTTGCCAAGGATGTTT
ASV252	AGAGTGTCCCGGGCGGCCGGCATGTTTACTTTGAAAAAATTAGAGTGCTCAAAGCAGGCTATTACGCTTGAATATTCGTGCATGGAATAATAGAATAGGAAGTCGTTTCTATTTTGTTGGTTTTTAAGTTTCGACTTAATGATTAATAGGGACAAACGGGGGCATTTGTATTCAAACGACAGAGGTGAAATTCTTGGACCGTTTGAAGACAAACTACTGCGAAAGCATTTGCCAAGAGTGTTT
ASV253	AGCTCCAATAGCGTATATTAAAGTTGTTGCGGTTAAAAAGCTCGTAGTGTCCCGGGTGGCCGGCATGTTTACTTTGAAAAAATTAGAGTGCTCAAAGCAGGCTATTACGCCTGAATATTCGTGCATGGAATAATAGAATAGGAAGTCGTTTCTATTTTGTTGGTTTTCGGAAATCGACTTAATGATTAATAGGGACAGTCGGGGGCATTTGTATTCAAACGACAGAGGTGAAATTCTTGGACCGTTTGAAGACAAACTACTGCGAAAGCATTTGCCAAGAATGTTT
ASV254	AGCTCCAATAGCGTATATTAAAGTTGTTCTGGTAAAAAAGCTTGTAGTTGGATCTCGGCGGACTGAGGGCGGCTTGCTTGTTAGTATTGCTGCCCTTTAGTCCATAGTTTTGCCCGAGGTTTCGGGGTGCTCTTTATCGAGTGTCCTGGGATGCTGCCTGGTTTTCTTTGAAAAAATTAGAGTGCTATTTTGTTGGTTTTCAGAAATCGACCTAATGAATAACAGGGACACACGGAGGCATTTGTATTCAGACGACAAAGGTGAAATTCTTGGACCGTTTAAAGACAAACTACTTCGAAAGCCTTTGCCAATA
ASV255	AGCTCCAATAGCGTATATTAAAGTTGTTGCGGTTAAAAAGCTCGTAGTTGGATCTCAGTTCCGGACCGACGGTACGCCGCCCGGCGTCCGGCATGTTTACTTTGAAAAAATTAGGGTGCTCAGAGCAGGCCAAGGCGCCTGAATACTTGTGCATGGAATAATGGAATAGGACCTCGGTTCTATTTTGTTGGTTTTAAGAGCCCGAGGTAATGATTAACAGGAACAGACGGGGGCATCCGTATTGCGACGTTAGAGGTGAAATTCTTGGACCGTCGCAAGACGAACGACTGCGAAAGCATTTGCCAAGGATGTTT
ASV256	AGCTCCAATAGCGTATATTAAAGTTGTTGTGGTTAAAAAGCTCGTAGTTGGATCTCAACAGCCTTGAAGCGGTTAACTTTGTAGTTTTACTGCTTTATAGGCTGTGCTTTTGCTGGAGGTTTAGGGGTGCTCTTGATCGAGTGTCTCGATGTCGATCCTATTTTGTTGGTTTTCGGGACTCGACATAATGATAAATAGGGACAGTCGGGGGCATTTGTATTCAAACGACAGAGGTGAAATTCTTGGACCGTTTGAAGACAAACTACTGCGAAAGCATTTGCCAAGAATGTTT
ASV257	AGCTCCAATAGCGGCTCGGTCGGGGTTGCTCTTCATCGAGTGTCCCGGGCGGCCGGCATGTTTACTTTGAAAAATTAGGGTGCTCAGAGCAGGCCAAGGCGCCTGAATACTTGTGCATGGAATAATGGAATAGGACCTCGGTTCTATTTTGTTGGTTTTAAGAGCCCGAGGTAATGATTAATAGGAACAGACGGGGGCATTCGTATTGCGACGTTAGAGGTGAAATTCTTGGATCGTCGCAAGACGAACTACTGCGAAAGCATTTGCCAAGAATGTTT
ASV258	AGCTCCAATTTTGAAAAAATTAGAGTGCTCAAAGCAGGCTATTACGCTTGAATATTCGTGCATGGAATAATAGAATAGGAAGTTGTTTCTATTTTGTTGGTTTTCGGAAATCGACTTAATGATTAATAGGGACAGTCGGGGGCATTTGTATTCAAACGACAGAGGTGAAATTCTTGGACCGTTTGAAGACAAACTACTGCGAAAGCATTTGCCAAGAATGTTT
ASV259	AGCTCCAATAGCGTATATTAAAGTTGTTGCGGTTAAAAAGCTCGTAGTTGGATCTCGGCAAGTAGAGGGCGGTATGCTGGCAGGTTTACTTTGAAAAAATTAGAGTGCTCAAAGCAGGCTATTACGCTTGAATATTCGTGCATGGAATAATAGAATAGGAAGTTGTTTCTATTTTGTTGGTTTTCGGAAATCGACTTAATGATTAATAGGGACAGTCGGGGGCATTTGTATTCAAACGACAGAGGTGAAATTCTTGGACCGTTTGAAGACAAACTACTGCGAAAGCATTTGCCAAGAGTGTTT
ASV260	AGCTCCAATAGCGTATATTAAAGTTGTTGCGGTTAAAAAGCTCGTAGTTGGATCTCGGCAAGTAGAGGGCGGTATGCTTCGTAGCATTACTGCCCTATTACTTGTAGTTTTGCCAGAGGTTCCTGGGTGCTCTTAATCGAGTGTCTAGGGATGCTGGCAGGTTTACTTTGAAAAAATTAGAGTGCTCAAAGCAGGCTATTACGCTTGAATATTCGTGCATGGAACGAATATCAAACGACAGAGGTGAAATTCTTGGACCGTTTGAAGACAAACTACTGCGAAAGCATTTGCCAAGAATGTTT
ASV261	AGCTCCAATAGCGTATATTAAAGTTGTTGCGGTTAAAAAGCTCGTAGTTGGATCTCGGCAAGTAGAGGGCGGTATGCTTCGTAGCATTACTGCCCTATTACTTGTAGTTTTGCCAGAGGTTCCTGGGTGCTCTTAATCGAGTGTCTAGGGATGCTGGCAGGTTTACTTTGAAAAAATTAGAGTGCTCAAAGCAGGCTTTTACGCCTGGATATTCGTGCATGGAATAATAGAATAGGAAGTCGTTTCTATTTTGCCAAGAATGTTTTCA
ASV262	AGCTCCAATAGCGTATATTAAAGTTGTTGCGGTTAAAAAGCTCGTAGTTGGATCTCGGCAAGTAGAGGGCGGTATGCTTCGTAGCATTACTGCCCTATTACTTGTAGTTTTGCCAGAGGTTCCTGGGTGCTCTTAATCGAGTGTCTAGGGATGCTGGCAGGTTTACTTTGAAAAAATTAGAGTGAGGACCGTAGCGATTCTGACGTGCAAATCGATCGTCGGAGCTGGGTATAGGGGCGAAAGACTAATCGAACCATCTAGTAGCTGGTTCCTTCCGAAGTTTCCCTCAGGATAGCTGGCACTCATTTACGAGAATGTTT
ASV263	AGCTCCAATAGCGTATATTAAAGTTGTTGCAGTTAAAAAGCTCGTAGTTGGATTTCGGAGTGGGCCAGTTGGTCCGCCGCAAGGTGTGTTACTGACTGGTTTGCTCTTCTTCGCAAAGACTGCGTGTGCTCTTTATTGAGTGTGCGTAGGATTTACGACGTTTACTTTGAAAAAATTAGAGTGTTCAATCCGTATTTCGTTGTCAGAGGTGAAATTCTTGGATTTACGAAAGACGAACAACTGCGAAAGCACTTGCCAAGAGTGTTT
ASV264	AGCTCCAATAGCGTATATTAAAGTTGTTGCGGTTAAAAAGCTCGTAGTTGGATCTCGGCAAGTAGAGGGCGGTATGCTTCGTAGCATTACTGCCCTATTACTTGTAGTTTTGCCAGAGGTTCCTGGGTGCTCTTAATCGAGTGTCTAGGGATGCTGGCAGGTTTACTTTGAAAAAATTAGAGTGCTCAAAGCAGGCTATTACGCTTGAATATTCGTGCATGGAATAATAGAATAGGAAGTTGTTTCTATTTTGTTGGTTTTCGGAAATCAACTTAATGATGCCAAGAATGTTT
ASV265	AGCTCCAATAGCGTATATTAAAGTTGTTGTGGTTAAAAAGCTCGTAGTTGGATCTCAACAGCCTTGAAGCGGTTAACTTTGTAGTTTTACTGCTTTATAGGCTGTGCTTTTGCTGGAGGTTTAGGGGTGCTCTTGATCGAGTGTCTCTGGATGCCAGCAGGTTTACTTTGAAAAAATTAGAGTGCTCAAAGCAGGCTAAAATGCCTGAATATTCGTGCATGGAATAATAGAATAGGATGTCGATCCTATTTTGTTGGTTTTCGGGACTCGACATAATTGCCATTTGCCAAGAATGTTT
ASV266	AGCTCCAATAGCGTATATTAAAGTTGTTGTGGTTAAAAAGCTCGTAGTTGGATCTCAACAGCCTTGAAGCGGTTAACTTTGTAGTTTTACTGCTTTATAGGCTGTGCTTTTGCTGGAGGTTTAGGGGTGCTCTTGATCGAGTGTCGTTTGAAGACAAACTACTGCGAAAGCATTTGCCAAGAATGTTTTCA
ASV267	AGCTCCAATAGCGTATATTAAATAATAGAATAGGAAGTTGTTTCTATTTTGTTGGTTTTCGGAAATCGACTTAATGATTAATAGGGACAGTCGGGGGCATTTGTATTCAAACGACAGAGGTGAAATTCTTGGACCGTTTGAAGACAAACTACTGCGAAAGCATTTGCCAAGAATGTTTTCACTAATCAAGAACGAGT
ASV268	AGCTCCAATAGCGTATATTAAAGTTGTAATCGAGTGTCTAGGGATGCTGGCAGGTTTACTTTGAAAAAATTAGAGTGCTCAAAGCAGGCTATTACGCTTGAATATTCGTGCATGGAATAATAGAATAGGAAGTTGTTTCTATTTTGTTGGTTTTCGGAAATCGACTTAATGATTAATAGGGACAGTCGGGGGCATTTGTATTCAAACGACAGAGGTGAAATTCTTGGACCGTTTGAAGACAAACTACTGCGAAAGCATTTGCCAAGAATGTTT
ASV269	AGATCCAATAGCGTATATTAAAGTTGTTGTGGTTAAAAAGCTCGTGATTGGATCTCGGCGAACCTAGGGCGGTTTGTTTGCTAGTATTACTGCCCTATAGTCTGTAATTTTGCAAGAGGTTTCTGGGTGCTCTTAATCCAATGTCCAGGGATGCTGGCAAACTAATGGAAAAGCATTTGCCAAGAATGTTTTTA
ASV270	AAGACTTTTACTTTGAGGAAATTAGAGTGTTCACGGCAAGCTATCGCTTTGAATACATTAGCATGGAAAAATAATATAGGGCGTAAGTCTTATTTTGTTGGTTTCTAGGACATACGCAATGATTAATAGGGACAATTGGGGACAGACTCGTATGAACGCGACATTGAGGTGGAATTCTTAGATTGCGTTACGACGAACTACTGCGAAAGCATTTGCCAAGGATTTGTTTTCA
ASV271	AGCTCCAATAGCGTATATTAAAGTTAATGTGGTTAAAAAGCTCGTAGTTGGATCTCAACAGCCTTGAAGCAGTTAACTTTGTAGTTTTACTGCTTTATAGGCTGTGCTTTTGCTGGAGGTTTAGGGGTGCTCTTGATTGAGTGTCTCTGGATGTCAATCCTATTTTGTTGGTTTTCGGGACTCGACATAATGATAAATAGGGACAGTCGGGGGCATTCAAACGACAGAGGTGAAATTCTTGGACCGTTTGAAGACAAACTACTGCGATAGCATTTGCCAAGAATGTTT
ASV272	AGCTCCAATAGCGTATATTAAAGTTGTTGTGGTTAAAAAGCTCGTAGTTGGATCTCGGCGGACTGAGGGCGGTTTGCTTGCTAGTATTACTGCCCTATAGTCCGTAGTTTTGCCAGAGGTTTCGGGGTGCTCTTAATCGAGTGTCCCGGGATGCTGGCAGGTTTACTTTGAAAAAATTAGAGTGCTCAAAGCAGGCTATTATGCCTGAATATTCGTGCATGGAATAATAGAATAGGAAGTCGTTTCTATTTTGACAGAGGTGAAATTCTTGGACCGTTTGAAGACAAACTACTGTGAAAGCATTTGCCAAGAATGTTT
ASV273	AGCTCCAATAGCGTATATTAAAGTTGTTGCGGTTAAAAAGCTCGTCGGGGTTGCTCTTCATCGAGTGTCCCGGGCGGCCGGCATGTTTACTTTGAAAAAATTAGGGTGCTCAGAGAAGGCCAAGGCGCCTGAATACTTGTGCATGGAATAATGGAATAGGACCTCGGTTCTATTTTGTTGGTTTTAAGAGCCCGAGGTAATGATTAACAGGAACAGACGGGGGCATCCGTATTGCGACGTTAGAGGTGAAATTCTTGGACCGTCGCAAGACGAACGACTGCGAAAGCATTTGCCAAGGATGTTT
ASV274	AGCTCCAATAGCGTATATTAAAGTTGTTGCGGTTAAAAAGCTCGTAGTTGGATCTCAGTTCCGTTACTTGTGCATGGAATAATGGAATAGGACCTCGGTTCTATTTTGTTGGTTTTAAGAGCCCGAGGTAATGATTAATAGGAACAGACGGGGGCATTCGTATTGCGACGTTAGAGGTGAAATTCTTGGATCGTCGCAAGACGAACTACTGCGAAAGCATTTGCCAAGAATGTTT
ASV275	GTCGGTAAAACTCGTGCCAGCCACCGCGGTTATACGAGAGACCCAAGTTGATAACTCCCGGCGTAAAGCGTGGTTAAGGAAACCTCAAACTAAAGTCGAACACTCTCAAAGCTGTTATACGCACATCGAGAACATGAAGAACTACCACAAAAGTGACTTTAAGCCCACCCCGAACCCACGAAAGCTAAGATACAAACTGGGATTAGATACCCCACTATG
ASV276	AGCTCCATTAGTATATATCATTGTTGTTGTGGTTAAAAAGCTCGTAGTTGGATCTCTTCGGTTTTAGATCGGTTCACTTTTTGGGTGCTACTGATCTATAGGCCGTACTTTTGTCAGAGGTCTCAGGGTGCTCTTAATCGAGTGTCTTGTGATGCTGGCAGGTTTACTTTGAAAAAATTAGAGTGCTCAAAGCAGGCTATTACGCCTGAATATTCGTGCATGGAATAATAGAATAGGAAGTCGTTTCTATTTTGTTGGTGAAATTCTTGGACCGTTTGAAGACAAACTACTGCGAAAGCATTTGCCAAGAATGTTT
ASV277	TTCACTACTCAATCGTAACGAGAGTGAACAACGCCTTTCAACGAGAATCCTGCAAGAATGCACAACGATAAGAGAAGCAGAGGCACTGGTAATACGAACGGTAGGGAATTTAGAAAACGAATGCCAAGCGACGGAGATGATGTTCAACCTGAAGCGCAGCAACCGATCCTTAGAAGACTTTTACACGATC
ASV278	AGTTCCGAAAGCGTATACTAAAATTGTTGCGGTTGAAACGCTCGTAGTCTAGTAAGTGGATCGAGTGGGAGTCGTCCGCGGCGGCGTCTGTGGATTCGGCCCTACCGAACCCCTTTGAATTCCGACAATCCGATCGGTGCTCTTCATTGAGCGTCGAGGAGCGTCTGGAGAACCTTCTACCGTGAGAAAACCGGAGTGCTCCAAGCCTGACTCTTGCCGGTCTTTATGACCGACGGCGATCGAAAGTTCGCGGCACGACACTGATTTTAGTCGGCGGACGGGTCATACACCACT
ASV279	AGCTCCAATAGCGTATATTAAAGTTGTTGTGGTTAAAAAGCTCGTAGTTGGCAGGTTTACTTTGAAAAAATTAGAGTGTTCAAAGCAGGCTATTGCTTGAATACATGAGCATGGAATAATGGAATAGGACTTTGGTCCCATTTTGTTGGTTTCTAGGGCCGAAGTAATGATTAAGAGGGACAATTGGGGGCATCCGTATTTCGTTGTCAGAGGTGAAATTCTTGGATTTACGAAAGACGAACAACTGCGAAAGCACTTGCCAAGAGTGTTT
ASV280	AGCTCCAATAGCGTATATTAAAGTTGTTGTGTTGTTGTTGTGCTTTTGCTGGAGGTTTAGGGGTGCTCTTGATCGAGTGTCTCTGGATGCCAGCAGGTTTACTTTGAAAAAATTAGAGTGCTCAAAGCAGGCTAAAATGCCTGAATATTCGTGCATGGAATAATAGAATAGGATGTCGATCCTATTTTGTTGGTTTTCGGGACTCGACATAATGATAAATAGGGACAGTCGGGGGCATTTGTATTCAAACGACAGAGGTGAAATTCTTGGACCGTTTGAAGACAAACTACTGCGAAAGCATTTGCCAAGAATGTTT
ASV281	AGCTCCAATAGCGTATATTAAAGTTGTTGCGGTTAAAAAGCTCGTAGTTGGATCTCGGCGGGCAGAGTTAATGATTAACAGGGACAATTGGGGGCATTAGTATTCAGACGACAGAGGTGAAATTCTTGGACCGTCTGAAGACTGACTACTGCGAAAGCATTTGCCAAGAGTGTTTTCA
ASV282	GTCGGTAAAACTCGTGCCAGCCACCGCGGTTATACGAGAGGCCCTAGTTGATAACTACCGGCGTAAAGAGTGGTTACGGAAAAATATTTAATAAAGCCGAACACCCCCTCAGCCGTCATACGCACCTGGGGGCACGAAGATCTACTACGAAAGCAGCTTTAATTATACCTGAACCCACGACAGCTACGACACAAACTGGGATTAGATACCCCACTATG
ASV283	GTTGGTAAATCTCGTGCCAGCCACCGCGGTCATACGATTAACCCAAACTAATAGGCCTATGGCGTAAAGCGTGTTCAAGATACTTTTACACTAAAGTTAAAACTTAACTAAGCCGTAAAAAGCTACAGTTATCATAAAATAAACCACGAAAGTGACTTTATAATAATCTGACTACACGATAGCTAAGACCCAAACTAGGATTAGATACCCCACTATG
ASV284	GTCGGTAAAACTCGTGCCAGCCACCGCGGCTATACGAGAGACCCAAGTTGATACCATTCGGCGTAAAGAGTGGTTATGGAAAATAAATACTAAAGCCGCACACCTTCAAAGCTGTTATACGCATCCGAAGGTTAGAAGACCAACCACGAAGGTAGCTTTACAACCCCTGACCCCACGAAAGCTCTGGCACAAACTGGGATTAGATACCCCACTATG
ASV285	AGCTCCAATAGCGTATATTAAAGTTGTTGTGGTTAAAAAGCTCGTAGTTGGATCTCAACAGCCTTGAAGCGGTTAACTCTGGATGCCAGCAGGTTTACTTTGAAAAAATTAGAGTGCTCAAAGCAGGCTAAAATGCCTGAATATTCGTGCATGGAATAATAGAATAGGATGTCGATCCTATTTTGTTGGTTTTCGGGACTCGACATAATGATAAATAGGGACAGTCGGGGGCATTTGTATTCAAACGACAGAGGTGAAATTCTTGGACCGTTTGAAGACAAACTACTGCGAAAGCATTTGCCAAGAATGTTT
ASV286	AGCTCCAATAGCGTATATTAAAGTTGTTGCAGCTAAAACGCTCGTAGTCCTTCCGGAGACTGGCCCTACTCTTAACTGAGCGGGGTCGGGAGACGGATCGTTTACTTTGAAAAAATCAGAGTGTTTCAAGCAGGCAGCTCGCTCTTGCATGGATTAGCATGGGATAATGAAATAGGACTTTGGTGCTATTTTGTTGGTTTCGAACACCGAAGTAATGATTAACAGGGACAGTCAGGGGCACTCGTATTCCGCCGAGAGAGGTGAAATTCTCAGACCAGCGGAAGACGAACCACTGCGAAAGCATTTGCCAGGGATGTTTTCA
ASV287	TTGTCAATTTTCATGTATCCCCTTCTCCCTTCCTCTGTCTCTCACTTCTTGTATCTCTTTGCTTCCCCCTTCCCCTCCTTTCTGTGCACTAACTTCTCTATCTTTTCTCGTCTCTCTTTATTCTATTATTCCTTCCTTTTCTCTATCTATCTTTCTCTCTTCCTTTTCTCTCACTTCTACCTTTATCTTTTTCTTCTCTTACTTCGTAACTATGGACGTTTTCGTCCTTGTTTTTATTCCAACCAGGGTTTAGATTTTTTTAAAAGGGTGCGAAAGAAAAAAATCATAATGTAATTTTT
ASV288	AGCTCCAATAGCGTATATTAAAGTTGTTGTGGTTAAAAAGCTCGTAGTTGGATCTCAACAGCCTTGAAGCGGTTAACTTTGTAGTTTTTTTAGTTTTTTGAAAAAATTAGAGTGCTCAAAGCAGGCTAAAATGCCTGAATATTCGTGCATGGAATAATAGAATAGGATGTCGATCCTATTTTGTTGGTTTTCGGGACTCGACATAATGATAAATAGGGACAGTCGGGGGCATTTGTATTCAAACGACAGAGGTGAAATTCTTGGACCGTTTGAAGACAAACTACTGCGAAAGCATTTGCCAAGAATGTTT
ASV289	GTTGGTAAATCTCGTGCCAGCCACCGCGGTCATACGATTAACCCAAATTAATAGGCATACGGCGTAAAACGTGTTAAAGCACAACATTAAATAAAGTTAAATTTCAATTAAACTGTAAAAAGTCATAATTGCAATGAAAATAGATAACGAAAGTAACTTTACAGCCACTGAAACACGATAGCTAAGACCCAAACTAGGATTAGATACCCCACTATG
ASV290	AGCTCCAATAGAACTTATAACAGAGTGCTTATAACAGGCGTGAAGCTTGTATATGTGTGCATGGAATAATAGAACAAGATTTCAATTTCGTTCTGTTGGTTGACGAGGCGGAAATAATGATTAATCGGGACTGCCGGGTGCATAGGTATTCAGGAGCGAGAGGTGAAATTCGGTGACCTCCTGAAGACCACCTATTGCGAAGGCATTTGCAAAGAATGTTT
ASV291	CTCGGTCCATTGTGGCACCCGCACGAGGCTGAGGTAGGCGCCCCCCAAGCCGGCACAGGCACCGCCGAACATGATCGCCAAAAGCCGGATACGGATTACCTTATAGCCCAGGGCATGGGCGGCATCATGGTTTTCGCCCTCGCCACGTAAAATCGGCCCGGCTCGGCTGTATTTCAGCACAGCCCAGACCGCAAAGACCAGTGCAAGGCTGACATAGACCATCGGATCATGTGAAAACACGATCGGGCCCAAAACTGGAATATCGGACAGACCGGGGATATCAAGCGCCGGCAATGTTGGCGATTTCATCCCTTCATAGGGT
ASV292	CTCGGTCCATTGTGGCACCCGCACGAGGCTGAGGTAGGCGCCCCCCAAGCCGGCACAGGCACCGCCGAACATGATCGCCAAAAGCCGGATACGGATTACCTTATAGCCCAGGGCATGGGCGGCATCATGGTCTTCGCCCACGCCACGTAAAATTAGCCCGGCTCGGCTGTATTTCAGCACAGCCCAGACCGCAAAGACCAGTGCAAGGCTGACATAGACCATCGGATCATGTGAAAACACGATCGGGCCCAAAACTGGAATATCGGACAGACCGGGGATATCAAGCGCCGGCAATGTTGGCGATTTCATCCCTTCATAGGGT
ASV293	ACGTTTTTGACCTGAACGTTCTAATTGATATTTCATATCTCTAACTAAATTTCTAAATGCAGTTCTAAACAGATCTGCAAGCATTTGTCCTGCAAATTTGATTACTTTGTTTCCATAATGATCTTTGTCATCCGGAGTAATCCAACCAAGTTTTAATTCTAATAATTTACAAGCTGCTTCACCTAAGAATTGTGCTTTTTCTTTTCTATTTTCAGGATGTTTACCCAAATGAGGCAATAGACC
ASV294	AGCTCCAATAGCGTATATGCTTTTGCTGGAGGTTTAGGGGTGCTCTTGATCGAGTGTCTCTGGATGCCAGCAGGTTTACTTTGAAAAAATTAGAGTGCTCAAAGCAGGCTAAAATGCCTGAATATTCGTGCATGGAATAATAGAATAGGATGTCGATCCTATTTTGTTGGTTTTCGGGACTCGACATAATGATAAATAGGGACAGTCGGGGGCATTTGTATTCAAACGACAGAGGTGAAATTCTTGGACCGTTTGAAGACAAACTACTGCGAAAGCATTTGCCAAGAATGTTT
ASV295	AGCTCCAATAGCGTATTCGTGCATGGAATAATAGAATAGGATGTCGATCCTATTTTGTTGGTTTTCGGGACTCGACATAATGATAAATAGGGACAGTCGGGGGCATTTGTATTCAAACGACAGAGGTGAAATTCTTGGACCGTTTGAAGACAAACTACTGCGAAAGCATTTGCCAAGAATGTTT
ASV296	AGCTCCAATAGCGTATATTAAAGTTGTTGCGGTTAAAAAGCTCGTAGTTGGATTTCTGCTGAGGACGACCGGTCCGCCCTCTGGGTGTGTATCTGGCTCGGCCTGGGCATCTTCTTGGAGAACGTAGCTGCACTTGACTGATTAATAGGGATAGTTGGGGGCATTCGAATTTAACTGTCAGAGGTGAAATTCTTGGATTTGTTAAAGACGGACTACTGCGAAAGCATTTGCCAAGGATGTTTTCA
ASV297	AGCTCCAATAGCGTATATTAAAGTTGTTGTGGTTAAAAAGCTCGTAGTTGGATCTCAACAGCCTTGAAGCGGTTAACTTTGAAAAAATTAGAGTGCTCAAAGCAGGCTAAAATGCCTGAATATTCGTGCATGGAATAATAGAATAGGATGTCGATCCTATTTTGTTGGTTTTCGGGACTCGACATAATGATAAATAGGGACAGTCGGGGGCATTTGTATTCAAACGACAGAGGTGAAATTCTTGGACCGTTTGAAGACAAACTACTGCGAAAGCATTTGCCAAGAATGTTT
ASV298	AGCTCCAATAGCGTATATTAAAGTTGTTGTGGTTAAAAAGCTCGTAGTTGGATCTCAACAGCCTTGAAGCGGTTAACTTTGTAGTTTTACTGCATGGAATAATAGAATAGGATGTCGATCCTATTTTGTTGGTTTTCGGGACTCGACATAATGATAAATAGGGACAGTCGGGGGCATTTGTATTCAAACGACAGAGGTGAAATTCTTGGACCGTTTGAAGACAAACTACTGCGAAAGCATTTGCCAAGAATGTTT
ASV299	AGCTCCAATAGCGTATATTAAAGTTGTTGCGGTTAAAAAGCTCGTAGTTGGATTTCTGCCGAGGACGACCGGTCCGCCCTCTGGGTGAGCATCTGGTTCGACCTGGGCATCTTCTTAGCAGGCACACGCCTTGAATACATTAGCATGGAATAATAAGATAGGACCTCGGTTCTATTTTGTTGGTTTCTAGAGCTGAGGTAATGATTAATAGGGATAGTTGGGGGCATTCGTATTTAACTGTCAGAGGTGAAATTCTTGGATTTGTTAAAGACGGACTACTGCGAAAGCATTTGCCAAGGATGTTT
ASV300	CGTTAATTCACCCAATGCCCTACTCCGTCCTTAATAGATATCCGCACGTTAGCAAATATCCACAGGGGAAACTACGTTAATACCCCATCGCTCTGGCTAATGGTCAATCAACTGAGCTGTCGGAACCATCATGTTAGTGCAAATTCCGTATTCGTCAGTGATGGCCTGATCCAATAAAGCCCTGGGTTCAAA
ASV301	AGCTCCAAGAGCGTATATTAAAGTTGCAGTTAAAAAGCTCGTAGTTGGATTTCTGGTGGCCCGCGGCGGTTACGTCTGTGAGTGCCTCCTTTTTGGGCCAGACTCGCGATCTAGATCTTTTACTTTGAAAAAATTAGAGCGTTTCAAGCAGGCGTTTTGCTGTGAACACATTGGCATGGAATAATAATCTAGGACTTCGGTTCTATTTTGGTTTCTAGTTCCGAAGTAATGATTGATAGGGATAGTTGCGGCCAGAGGTGAAATTCTTGGATTCGGTCAAGACTAACTTATGCGAAAGCATTCACCCAGGGCGTCTTCT
ASV302	AGCTCCAATAGCGTATATTAAAGTTGTTGTGGTTAAAAAGCTCGTAGTTGGACGCTGGCAGGTTTACTTTGAAAAAATTAGAGTGCTCAAAGCAGGCTATTACGCCTGAATATTCGTGCATGGAATAATAGAATAGGAAGTCGTTTCTATTTTGTTGGTTTTCGGAAATCGACTTAATGATTAATAGGGACAGTCGGGGGCATTTGTATTCAAACGACAGAGGTGAAATTCTTGGACCGTTTGAAGACAAACTACTGCGAAAGCATTTGCCAAGAATGTTT
ASV303	AGCTCCAATAGCGTATATTAAAGTTGTTGTGGTTAAAAAGCTCGTGGTGTTCTTCACAGTTTGCATTTCCGAGCTCAGACAAGTGTCTCAGAGGCTGTCTCATGTCCCATGTCTCATGTCCCATGTCTCATGTCTCAAGTCTCAAGTCTCAAGTCTCTGGACATAAAATAATGTCTAGGGCATCGTGTATTCCCAAGCGGTCACCCATCCAAGTACTAACACGACTCAATGTTGCTTGGACCGTTTGAAGACAAACTACTGCGAAAGCATTTGCCAAGAATGTTT
ASV304	AGCTCCAATAGCGTATATTAAAGTTGTTGCGGTTAAAAAGCTCGTAGTTGGATCTCAGTTCCGGACCGACGGTACGCCGCCCGGCGTCTACGTTTACTTTGAAAAAATTAAGGTGCTCAGAGCAGGCCAAGGCGCCTGAATACTTGTGCATGGAATAATGGAATAGGACCTCGGTTCTATTTTGTTGGTTTTAAGAGCCCGAGGTAATGATTAATAGGAACAGACGGGGGCATTCGTATTGCGACGTTAGAGGTGAAATTCTTGGATCGTCGCAAGACGAACTACTGCGAAAGCATTTGCCAAGAATGTTT
ASV305	AGCTCCAATAGCGTATATTAAAGTTGTTGCGGTTAAAAAGCTCGTAGTTGGATCTCGGCGGACTGAGGGCGGTTTGCTTGCTAGTATTACTGCCCTATAGTCCGTAGTTTTGCCAGAGGTTTCGGGGTGCTCTTAATCGAGTGTCCCGGGATGCTGGCAGGTTTACTTTGAAAAAATTAGAGTGCTCAAAGCAGGCTATTACGCCTGTATTTGTATTCAAACGACAGAGGTGAAATTCTTGGACCGTTTGAAGACAAACTACTGCGAAAGCATTTGCCAAGAATGTTT
ASV306	AGCTCCAATAGCGTATATTAAAGTTGTTGTGGTTAAAAAGCTCGTAGTTGGATCTCGGCGGACTGAGGGCGGTTTGCTTGCTAGTATTACTGCCCTATAGTCCGTAGTTTTGCCAGAGGTTTCGGGGTGCTCTTAATCGAGTGTCCCGGGATGCTGGCAGGTTTACTTTGAAAAAATTAGAGTGCTCAAAGCAGGCTATTACGCTTGAATATTCAAACGACAGAGGTGAAATTCTTGGACCGTTTGAAGACAAACTACTGCGAAAGCATTTGCCAAGAATGTTT
ASV307	AACTCCGATAGCGTATATTAAAGTTGTTGTGGTTAAAAAGCTTGTAGTTGGATCTCGGCGGACTGAGGGCGGCTTGCTTGCGAGGTTTCGGGGTGCTCTTTATTGAGTGTCCCGGGATGCTGCCTGGTTTTCTTTGAAAAAATTAGAGTGCTATTTTGTTGGTTTTCAGAAATCAACTTAATGAGTAACAGGGACACACGGAGGCATTTGTATTCAGACGACAAAGGTGAAATTCTTGGACCGTTTAAAGACAAACTACTTCGAAAGCCTTTGCCAAGAATATTT
ASV308	AGCTCCAATAGCGTATATAGACCTATAGACCGTAGTTTTGCCAGAGGTCTCAGGGTGCTCTTAACCGAGTGTCTTGCGATGCTGGCAGGTTTACTTTGAAAAAATTAGAGTGCTCAAAGCAGGCTTTTACGCCTGAATATTCGTGCATGGAATAATAGAATAGGAAGTCGTTTCTATTTTGTTGGTTTTCGGAAATCGACTTAATGATTAATAGGGACAGTCGGGGGCATTTGTATTCAAACGACAGAGGTGAAATTCTTGGACCGTTTGAAGACAAACTACTGCGAAAGCATTTGCCAAGAATGTTT
ASV309	AGCTCCAATAGCGTATATTAAAGTTGTTGTGGTTAAAAAGCTCGTAGTTGGATCTCGGCGGACTGAGGGCGGTTTGCTTGCTAGTATTACTGCCCTATAGTCCGTAGTTTTGCCAGAGGTTTCGGGGTGCTCTTAATCGAGTGTCCCGGGATGCTGGCAGGTTTACTTTGAAAAAATTAGAGTGCTCAAAGCAGCTATTACGCCTGAATATTCGTGCAAAAGGAACACTCGGGGGCATTTGTATTCAAACGACAGAGGTGAAATTCTTGGACCGTTTGAAGACAAACTACTGCGAAAGCATTTGCCAAGAATGTTT
ASV310	AGCTCCAATAGCGTATATTAAAGTTGTTGCAGTTAAAAAGCTCGTAGTTGGATTTCGGAGTGGGCCAGTTGGTCCGCCGCAAGGTGTGTTACTGACTGGTTTGCTCTTCTTCGCAAAGGCTGCGAGTGTTCAAAGCAGGCTATTGCTTGAATACATGAGCATGGAATAATGGAATAGGACTTTGGTCCCATTTTGTTGGTTTCTAGGGCCGAAGTAATGATTAAGAGGGACAATTGGGGGCATCCGTATTTCGTTGTCAGAGGTGAAATTCTTGGATTTACGAAAGACGAACAACTGCGAAAGCACTTGCCAAGAGTGTTT
ASV311	AGCTCCAATAGCGTATATTAAAGTTGTTGTGGTTAAAAAGCTCGTAGGCTCGGTCGGGGTTGCTCTTCATCGAGTGTCCCGGGCGTCCGGCATGTTTACTTTGAAAAAATTAGGGTGCTCAGAGCAGGCCAAGGCGCCTGAATACTTGTGCATGGAATAATGGAATAGGACCTCGGTTCTATTTTGTTGGTTTTAAGAGCCCGAGGTAATGATTAACAGGAACAGACGGGGGCATCCGTATTGCGACGTTAGAGGTGAAATTCTTGGACCGTCGCAAGACGAACTACTGCGAAAGCATTTGCCAAGAATGTTT
ASV312	AGCTCCAATAGCGTATATTAAAGTTGTTGCGGTTAAAAAGCTCGTAGTTGGATCTCAGTTCCGGACCGACGGTACGCCGCCCGGCGTCTACTGTCGGCTTCCGAACGCTAAAGCCCGTCGGCTCGGTCGGGGTGCTCTTCATCGAGTGTCCCGGGCGGCCGGCACGTTTACTTTGAAAAAAATTAGGCTACTCATAGCAGGCCAAGGCGCCTGAATACTTGTGCATGGAATAATGGAATAGGACCTCGGTTCTATTTTGTTCTATTTGCCAATAATGTTT
ASV313	AGCTCCACTAGCATATATTAAAGTTGTTGCGGTTAAACAGCTCGTAGTTGGATCTTCATCGAGTGTCCCGGGCGGCCGGCACGTTTACTTTGAAAAAATTAGGGTGCTCAGAGCAGGCCAAGGCGCCTGAATACTTGTGCATGGAATAATGGAATAGGACCTCGGTTCTATTTTGTTGGTTTTAAGAGCCCGAGGTAATGATTAACAGGAACAGACGGGGGCATCCGTATTGCGACGTTAGAGGTGAAATTCTTGGACCGTCGCAAGACGAACGACTGCGAAAGCATTTGCCAAGGATGTTT
ASV314	AGCTCCACTAGCATATATTAAAGTTGTTGCGGTTAAACAGCTCGTAGTTGGATCTTCATCGAGTGTCCCGGGCGGCCGGCACGTTTACTTTGAAAAAATTAGGGTGCTCAGAGCAGGCCAAGGCGCCTGAATACTTGTGCATGGAATAATGGAATAGGACCTCGGTTCTATTTTGTTGGTTTTAAGAGCCCGAGGTAATGATTAACAGGAACAGACGGGGGCATCCGTATTGCGACGTTAGAGGTGAAATTCTTGGACCGTCGCAAGACGAACTACTGCGAAAGCATTTGCCAAGAATGTTT
ASV315	AGCTCCAATAGCGTATATTAAAGTTGTTGTGGTTAAAAAGCTCATAGTTGGATCTCAGCTCCAGACCGACGGTACGCCACCCAGCGTCTACTGTCTGCTTCCAAACTTTGAAAAAATGAGGGTGCTCAGAGCAGGCCAAGGCACCTGAAAACTTGTGCATGGAATAATGGAATAGGACCTCGGTTCTATTTTGTTGGTTTTAAGAGCCCGAGGTAATGATTAATAGGGACAGTCGGGGGCATTTGTATTCAAACGACAGAGGTGAAATTCTTGGACCGTTTGAAGACAAACTACTGCGAAAGCATTTGCCAAGAATGTTT
ASV316	AGCTCCAATAGCGTATATTAAAGTTGTTGCGGTTAAAAAGCTTGTAGTTTTGCCAGAGGTTCCTGGGTGCTCTTAATCGAGTGTCTAGGGATGCTGGCAGGTTTACTTTGAAAAAATTAGAGTGCTCAAAGCAGGCTATTACGCTTGAATATTCGTGCATGGAATAATAGAATAGGAAGTTGTTTCTATTTTGTTGGTTTTCGGAAATCGACTTAATGATTAATAGGGACAGTCGGGGGCATTTGTATTCAAACGACAGAGGTGAAATTCTTGGACCGTTTGAAGACAAACTACTGCGAAAGCATTTGCCAAGAATGTTT
ASV317	AGCTCCAATAGCGTATATTAAAGTTGTTGTGGTTTTGCCAGAGGTTTTGGGGTGCTCTTAATCGAGTGTCCCGGGATGCTGGCAGGTTTACTTTGAAAAAATTAGAGTGCTCAAAGCAGGCTATTACGCCTGAATATTCGTGCATGGAATAATAGAATAGGAAGTCGTTTCTATTTTGTTGGTTTTCGGAAATCGACTTAATGATTAATAGGGACAGTCGGGGGCATTTGTATTCAAACGACAGAGGTGAAATTCTTGGACCGTTTGAAGACAAACTACTGCGAAAGCATTTGCCAAGAATGTTT
ASV318	AGCTCCAATAGCGTATATTAAAGTTGTTGCAGTTAAAAAGCTCGTAGTTGGATCTCAGTTCCGGACCGACGGTACGCCGCCCGGCGTCTACTGTCGGCTTCCGAACGCTAAAGCCCGTCGGCTCGGTCGGGGTGCTCTTCATCGAGTGTCCCGGGCGGCCGGCATGTTTACTTTGAAAAAATTAGGTTTTAAGAGCCCGAGGTAATGATTAATAGGAACAGACGGGGGCATTCGTATTGCGACGTTAGAGGTGAAATTCTTGGATCGTCGCAAGACGAACTACTGCGAAAGCATTTGCCAAGAATGTTT
ASV319	AGCTCCAATAGCGTATATTAAAGTTGTTGCGGTTAAAAAGCTCGTAGTTGGATCTTGGCAAGTAGAGGGCGGTATGCTTCGTAGCATTACTGCCCTATTACTTGTAATTAGAGTGCTCAAAGCAGGCTATTACGCTTGAATATTCGTGCATGGAATAATAGAATAGGAAGTTGTTTCTATTTTGTTGGTTTTCGGAAATCGACTTAATGATTAATAGGGACAGTCGGGGGCATTTGTATTCAAACGACAGAGGTGAAATTCTTGGACCGTTTGAAGACAAACTACTGCGAAAGCATTTGCCAAGAATGTTT
ASV320	AGCTCCAATAGCGTATATTAAAGTTGTTGCGGTTAAAAAGCTCGTAGTTGGATCTCAGTTCCGGACCGATGGTACGCCGCATGTTTACTTTGGAAAAATTAGGGTGCTCAGAGCAGGCCAAGGCGCCTGAATACTTGTGCATGGAATAATGGAATAGGACCTCGGTTCTATTTTGTTGGTTTTAAGAGCCCGAGGTAATGATTAACAGGAACAGACGGGGGCATCCGTATTGCGACGTTAGAGGTGAAATTCTTGGACCGTCGCAGGACGAACTACTGCGAAAGCATTTGCCAAGAATGTCT
ASV321	AGCTCCAATAGCGTATATTAAAGTTGTTGCGGTTAAAAAGCTCGTCGGGGTTGCTCTTCATCGAGTGTCCCGGGCGGCCGGCATGTTTACTTTGAAAAAATTAGGGTGCTCAGAGCAGGCCAAGGTGCCTGAATACTTGTGCATGGAATAATGGAATAGGACCTCGGTTCTATTTTGTTGGTTTTAAGAGCCCGAGGTAATGATTAACAGGAACAGACGGGGGCATCCGTATTGCGACGTTAGAGGTGAAATTCTTGGACCGTCGCAAGACGAACTACTGCGAAAGCATTTGCCAAGAATGTTT
ASV322	AGCTCCAATAGCGTATATTAAAGTTGTTGCGGTTAAAAAGCTCGTAGTTGGATCTCAGTTCCGGACCGACGGTACGCCACCCAGCGTCTACTGTCTGCTTCCAAACTTTGAAAAAATGAGGGTGCTCAGAGCAGGCCAAGGCACCTGAAAACTTGTGCATGGAATAATGGAATAGGACCTCGGTTCTATTTTGTTGGTTTTAAGAGCCCGAGGTAATGATTAACAGGAACAGACGGGGGCATCCGTATTGCGACGTTAGAGGTGAAATTCTTGGATTTACGAAAGACGAACAACTGCGAAAGCACTTGCCAAGAGTGTTT
ASV323	AGCTCCAATTGCTTGCTAGTATTACTGCCCTATAGTCCGTAGTTTTGCCAGAGGTTTTGCGGTGCTCTTAATCGAGTGTCCTGGGATGCTGGCAGGTTTACTTTGAAAAAATTAGAGTGCTCAAAGCAGGCTATTACGCCTGAATATTCATGCATGGAATAATAGAATAGGAAGTCGTTTCTATTTTGTTGGTTTTCGGAAATCGACTTAATGATTAATAGGGACAGTCGGGGGCATTTGTATTCAAACGACAGAGGTGAAATTCTTGGACCGTTTGAAGACAAACTACTGCGAAAGCATTTGCCAAGAATGTTT
ASV324	AGCTCCAATAGCGTATATTGTCCCGGGCGGCCGGCATGTTTACTTTGAAAAAATTAGGGTGCTCAGAGCAGGCCAAGGCGCCTGAATACTTGTGCATGGAATAATGGAATAGGACCTCGGTTCTATTTTGTTGGTTTTAAGAGCCCGAGGTAATGATTAATAGGAACAGACGGGGGCATTCGTATTGCGACGTTAGAGGTGAAATTCTTGGATCGTCGCAAGACGAACTACTGCGAAAGCATTTGCCAAGAATGTTT
ASV325	AGCTCCAATAGCGTATATTAAAGTTGTTGCGGTTAAAAAGCTCGTAGTTGGATCTCGGCAAGTAGAGGGCGGTATGCTTCGTAGAATAGGAAGTTGTTTCTATTTTGTTGGTTTTCGGAAATCGACTTAATGATTAATAGGGACAGTCGGGGGCATTTGTATTCAAACGACAGAGGTGAAATTCTTGGACCGTTTGAAGACAAACTACTGCGAAAGCATTTGCCAAGAATGTTTTCACCAATCAAGAAAAAGT
ASV326	AGTGGGCCAGTTGGTCCGCCGCAAGGTGTGTTACTGACTGGTTTGCTCTTCTTCGCAAAGACTGCGTGTGCTCTTGAGTGAGTGTGCGTAGGATTTACGACGTTTACTTTGAAAAAATTAGAGTGTTCAAAGCAGGCTATTGCTTGAATACATGAGCATGGAATAATGGAATAGGACTTTGGTCCCATTTTGTTGGTTTCTAGGGCCGAAGTAATGATTAAGAGGGACAATTGGGGGCATCCGTATTTCGTTGTCAGAGGTGAAATTCTTGGATTTACGAAAGACGAACAACTGCGAAAGCACTTGCCAAGAGTGTTT
ASV327	AGCTCCAATAGCATATATTAAAGTTGTTGTGGTTAAAAAGCTCATAGTTGGATCTCAGCTCCAGACCGACGGTACGCCACCCAGCGTCTACTGTCTGCTTCCAAACTTTGAAAAAATGAGGGTGCTCAGAGCAGGCCAAGGCACCTGAAAACTTGTGCATGGAATAATGGAATAGGACCTCGGTTCTATTTTGTTGGTTTTAAGAGCCCGAGGTAATGATTAATAGGAACAGACGGGGGCATTCGTATTGCGACGTTAGAGGTGAAATTCTTGGATCGTCGCAAGACGAACTACTGCGAAAGCATTTGCCAAGAATGTTT
ASV328	TAGCGCCAGGCGCACCACGCGCCGGACGGTGACATGATTGCCGAGAACAGTAGATACTCGGAGTCCACAGTTTCACAAGTTACAGATCAGTCCCTCTGCGGTCGATTTGTAAAGTGAACCGGGCCGCCACCAATTCACAGTTTTGTTACCAGGTTCTGTGTCTTCCGAATCATTGTCTCTGATTTCTTCAATAAA
ASV329	AGCTCCAATAGCGTATATTAAAGTTGTTGTGGTTAAAAAGCTCGTAGTTGGATCTCAACAGCCTTGAAGCGGTTAACTTTGTAGTTTTACTGCTTTATAGGCTGTGCTTTTGCTGGAGGTTTAGGGGTGCTCTTGATCGAGTGTCTCTGGATGCCAGCAGGTTTACTTTGAAAAAATTAGAGTGCTATTTTTTGATTTCAGAAATCGATTTAATGATTAACAGGGACACACGGGGGCATTTGTATTCAGACAACAAAGGTGAAATTCTTGGACCGTTTGAAGACGAACTACTGCGAAAGCATTTGCCAAGAATGTTT
ASV330	AGCTCCAATAGCGTATATTAAAGTTGTTGCGGTTAAAAAGCTCGTAGTTGGATCTCAGTTCCGGACCGACGGTACGCCGCCCGGCGTCTACTGTCGGCTTCCGAACGCTAAAGCCCGTCGGCTCGGTCGGGGTGCTCTTCATCGAGTGTCCCGGGCGGCCGGCATGTTTACTTTGAAAAAATTAGGGTGCTCAGAGCAGCCAAGAATGTTTTCA
ASV331	AGCTCCAATAGCGTATATTAAAGTTGTTGCGGTTAAAAAGCTCGTAGTTGGATCTCAGTTCCGGACCGACGGTACGCCGCCCGGCGTCTACTGTCGGCTTCCGAACGCTAAAGCCCGTCGGCTCGGTCGGGGTGCTCTTCATTGAGTGTCCCGGGCGGCCGGCATGTTTACTTTGAAAAAATTAGGGTGCTCAGAGCAGGCCCGAGGTAATGATTAATAGGAACAGACGGGGGCATTCGTATTGCGACGTTAGAGGTGAAATTCTTGGATCGTCGCAAGACGAACTACTGCGAAAGCATTTGCCAAGAATGTTT
ASV332	AGGGCGGTTTGCTTGCTAGTATTACTGCCCTATAGTCCGTAGTTTTGCCAGAGGTTTCGGGGTGCTCTTAATCGAGTGTCCCGGGATGCTGGCAGGTTTACTTTGAAAAAATTAGAGTGTTCAAAGCAGGCCTCGGCAGCCTGAATAATGGTGCATGGAATAATGGAATAGGACCTCGGTTCTATTTTGTTGGTTTTCGGAACGGAGGTAATGATTAACAGGGACAAACGGGGGCATTCGTATTGCGGCGTTAGAGGTGAAATTCTTGGATCGCCGCAAGACGAGCTACTGCGAAAGCATTTGTCAAGAATGTTT
ASV333	AGTGGGCCAGTTGGTCCGCCGCAAGGTGTGTTACTGACTGGTTTGCTCTTCTTCGCAAAGACTGCGTGTGCTCTTGAGTGAGTGTGCGTAGGATTTACGACGTTTACTTTGAAAAAATTAGAGTGTTCAAAGCAGGCTATTGCTTGAATACATGAGCATGGAATAATGGAATAGGACTTTGGTCCCATTTTGTTGGTTTTCGGAAATCGACTTAATGATTAATAGGGACAGTCGGGGGCATTTGTATTCAAACGACAGAGGTGAAATTCTTGGACCGTTTGAAGACAAACTACTGCGAAAGCATTTGCCAAGAATGTTT
ASV334	AGCTCCAATAGCGTATATTAAAGTTGTTGTGGTTAAAAAGCTCGTAGTTGGATCTCGGCGGACTGAGGGCGGTTTGCTTGCTAGTATTACTGCCCTATTACTTGTAGTTTTGCCAGAGGTTCCTGGGTGCTCTTAATCGAGTGTCTAGGGATGCTGGCAGGTTTACTTTGAAAAAATTAGAGTGCTCAAAGCAGGCTGTTTGTATTCAAACGACAGAGGTGAAATTCTTGGACCGTTTGAAGACAAACTACTGCGAGAGCATTTGCCAAGAATGTTT
ASV335	AGCTCCAATAGCGTATATTAAAGTTGTTGCGGTTAAAAAGCTCGTAGTTGGATCTCAGTTCCGGACCGACGGTACGCCGCCCGGCGTGTACTGTCGGCTTCCGAACGCTAAAGCCCGTCGGCTCGGTCGGGGTTGCTCTTCATCGAGTGTCCCGGGCGGCCGGCATGTTTACTTTGAAAAAATTAGGGTGCTCAGAGCAGGCCAAGGCGCCTGAATTGCCAAGGATGTTTTCA
ASV336	AGCTCCAATAGCGTATATTAAAGTTGTTGCGGTTAAAAAGCTCATAGTTGGATCTCAGCTCCAGACCGACGGTACGCCACCCAGCGTCTACTGTCTGCTTCCAAACTTTGAAAAAATGAGGGTGCTCAGAGCAGGCCAAGGCACCTGAAAACTTGTGCATGGAATAATGGAATAGGACCTCGGTTCTATTTTGTTGGTTTTAAGAGCCCGAGGTAATGATTAACAGGAACAGACGGGGGCATCCGTATTGCGACGTTAGAGGTGAAATTCTTGGACCGTCGCAAGACGAACTACTGCGAAAGCATTTGCCAAGAATGTTT
ASV337	AGCTCCAATAGCGTCTGAATACTTGTGCATGGAATAATGGAATAGGACCTCGGTTCTATTTTGTTGGTTTTAAGAGCCCGAGGTAATGATTAATAGGAACAGACGGGGGCATTCGTATTGCGACGTTAGAGGTGAAATTCTTGGATCGTCGCAAGACGAACTACTGCGAAAGCATTTGCCAAGAATGTTT
ASV338	AGCTCCAATAGCGTATATTAAAGTTGTTGCGGTTAAAAAGCTCATAGTTGGATCTCAGCTCCAGACCGACGGTACGCCACCCAGCGTCTACTGTCTGCTTCCAAACTTTGAAAAAATGAGGGTGCTCAGAGCAGGCCAAGGCACCTGAAAACTTGTGCATGGAATAATGGAATAGGACCTCGGTTCTATTTTGTTGGTTTTAAGAGCCCGAGGTAATGATTAATAGGAACAGACGGGGGCATTCGTATTGCGACGTTAGAGGTGAAATTCTTGGATCGTCGCAAGACGAACTACTGCGAAAGCATTTGCCAAGAATGTTT
ASV339	AGCTCCAATAGCGTATATTAAAGTTGTTGCTTTTGCTGGAGGTTTAGGGGTGCTCTTGATCGAGTGTCTCTGGATGCCAGCAGGTTTACTTTGAAAAAATTAGAGCGCTCAAAGCAGGCTATTACGCCTGAATATTCGTGCATGGAATAATAGAATAGGAAGTCGTTTCTATTTTGTTGGTTTTCGGAAATCGACTTAATGATTAATAGGGACAGTCGGGGGCATTTGTATTCAAACGACAGAGGTGAAATTCTTGGACCGTTTGAAGACAAACTACTGCGAAAGCATTTGCCAAGAATGTTT
ASV340	AGCTCCAATAGCGTATATTAAAGTTGTTGCGGTTAAAAAGCTCGTAGTTGGATCTCGGCAAGTAGAGGGCGGTATGCTTCGTAGCATTACTGCCCTATTACTTGTAGTTTTGCCAGAGGTTCCTGGGTGCTCTTAATCGAGTGTCTAGGGATGCTGGCAGGTTTACTTTGAAAAAATTAGAGTGCTCAAAGCAGGCTATTACGCTTGAATATTCGTGCATGGAATAATAGAATAGGAAGTTGTTTCAAACTACTGCGAAAGCATTTGCCAAGAATGTTC
ASV341	ACCAGAACTAGAACGATACTACAATACTTCGATGGCCAACCTTCCCGCAAATGAAGATTACGACACATTACCGGGCATACTGCTCTCAGTAAAGGAAGCTGCACTGATGCCAGAAATGAGAAAACCACCTAAAAGACTGGCAGGAAGGTTCCCTAACCTCAAAATTTGCACATCCGCATTAACCGGAAAAATTATGCCCCTAGGAACATTCGGAGAGGGACCCCAGAAACTTAGACAACTAAGAAGAATGGACACACAGCCCAACATCAAACAGAACCCAGATAACTATGACCCGATGACAATACTATG
ASV342	AGCTCCAATAGCGTCTACTGTCGGCTTCCGAACGCTAAAGCCCGTCGGCTCGGTCGGGGTTGCTCTTCATCGAGTGTCCCGGGCGGCCGGCATGTTTACTTTGAAAAAATTAGGGTGCTCAGAGCAGGCCAAGGCGCCTGAATACTTGTGCATGGAATAATGGAATAGGACCTCGGTTCTATTTTGTTGGTTTTAAGAGCCCGAGGTAATGATTAATAGGAACAGACGGGGGCATTCGTATTGCGACGTTAGAGGTGAAATTCTTGGATCGTCGCAAGACGAACTACTGCGAAAGCATTTGCCAAGAATGTTT
ASV343	AGCTCCAATAGCGTATATTAAAGTTGTTGTGGTTAAAAAGCTCGTAGTTGGATCTCAACAGCCTTGAAGCGGTTAACTTTGTAGTTTTACTGCTTTATAGGTTTACTTTGAAAAAATTAGAGTGCTCAAAGCAGGCTAAAATGCCTGAATATTCGTGCATGGAATAATAGAATAGGATGTCGATCCTATTTTGTTGGTTTTCGGGACTCGACATAATGATAAATAGGGACAGTCGGGGGCATTTGTATTCAAACGACAGAGGTGAAATTCTTGGACCGTTTGAAGACAAACTACTGCGAAAGCATTTGCCAAGAATGTTT
ASV344	AGCTCCAATAGCGTATATTAAAGTTGTTGTGGTTAAAAAGCTCGTAGTTGGATCTCGGCGGACTGAGGGCGGTTTGCTTGCTAGTATTACTGCCCTATAGTCCGTAGTTTTGCCAGAGGTTTCGGGGTGCTCTTAATCGAGTGTCCCGGGATGCTGGCAGGTTTACTTTGAAAAAATTAGAGTGCTCAAAGCAGGCTATTACACCTGAATATTCGTGCA
ASV345	GCAAGGTGTGTTACTGACTGGTTTGCTCTTCTTCGCAAAGACTGCGTGTGCTCTTTATTGAGTGTGCGTAGGATTTACGACGTTTACTTTGAAAAAATTAGAGTGTTCAAAGCAGGCTATTGCTTGAATACATGAGCATGGAATAATGGAATAGGACTTTGGTCCCATTTTGTTGGTTTCTAGGACCGAAGTAATGATTAAGAGGGACAATTGGGGGCATCCGTATTTCGTTGTCAGAGGTGAAATTCTTGGATTTACGAAAGACGAACAACTGCGAAAGCACTTGCCAAGAGTGTTT
ASV346	TAGTATTGCTAGTATTACTGCCCTATAGACTGTAGTTTTGCCAGAGGTAGTTGGGTGCTCTTAATCGAGTGTCCTATTATGCTGGCAGGTTTACTTTGAAAAAATTAGAGTGCTCAAAGCAGGCTATTACGCCTGAATATTCGTGCATGGAATAATAGAATAGGAAGTCGTTTCTATTTTGTTGGTTTTCGGAAATCGACTTAATGATTAATAGGGACAGTCGGGGGCATTTGTATTCAAACGACAGAGGTGAAATTCTTGGACCGTTTGAAGACAAACTACTGCGAAAGCATTTGCCAAGAGTGTTT
ASV347	AGCTCCAATAGCGTATATTAAAGTTGTTGCGGTTAAAAAGCTCGTAGTTGGATCTCGGCAAGTAGAGGGCTCTTAATCGAGTGTCTAGGGATGCTGGCAGGTTTACTTTGAAAAAATTAGAGTGCTCAAAGCAGGCTATTACGCTTGAATATTCGTGCATGGAATAATAGAATAGGAAGTTGTTTCTATTTTGTTGGTTTTCGGAAATCGACTTAATGATTAATAGGGACAGTCGGGGGCATTTGTATTCAAACGACAGAGGTGAAATTCTTGGACCGTTTGAAGACAAACTACTGCGAAAGCATTTGCCAAGAATGTTT
ASV348	AGCTCCAATAGCGTATATTAAAGTTGTTGTGGTTAAAAAGCTCGTAGTTGGATCTCGGCGGACTGAGGGCGGTTTGCTTGCTAGTATTACTGCCCTATAGACCGTAGTTTTGCCAGAGGTCTCAGGGTGCTCTTAACCGAGTGTCTTGCGATGCTGGCAGGTTTACTTTGAAAAAATTAGAGTGCTCAAAGCAGGCTTTCACGCCTGAATAGTCGGGGGCATTTGTATTCAAACGACAGAGGTGAAATTCTTGGACCGTTTGAAGACAAACTACTGCGAAAGCATTTGCCAAGAATGTTT
ASV349	AGCTCCAATAGTTGTTATTTTAAAGCTGTTGTGGTTAAAAAGCTCGTAGTTGGATCTCGGCGGACTGAGGGTGGTTTGCTTGCTAGTATTACTGCCCTATTGTCCGTAGTTTTGCCAGAGTTTTTGGGGTGCTCTTAATCGAATGTGTTAGGATGCTGGCAGATTTACTTTGAAAAAATTAGAGTGCTCAAAGCAGCCTATTACGCCTGAATATTCGTGCAAAAGGAACACTCGGGGGCATTTGTATTCAAACGACAGAGGTGAAATTCTTGGACCGTTTGAAGACAATCTACTGCAAAAGCATTTGCCAAGAATGTTT
ASV350	AGCTCCAATAGCGTATATTAAAGTTGTTGACTGCGTGTGCTCTTTATTGAGTGTGCGTAGGATTTACGACGTTTACTTTGAAAAAATTAGAGTGTTCAAAGCAGGCTATTGCTTGAATACATGAGCATGGAATAATGGAATAGGACTTTGGTCCCATTTTGTTGGTTTCTAGGACCGAAGTAATGATTAAGAGGGACAATTGGGGGCATCCGTATTTCGTTGTCAGAGGTGAAATTCTTGGATTTACGAAAGACGAACAACTGCGAAAGCACTTGCCAAGAGTGTTT
ASV351	AGCTCCAATAGCGTATATTAAAGTTGTTGCAGTTAAAAAGCTCGTAGTTGGATTTCGGAGTGGGCCAGTTGGTCCGCCGCAAGGTGTGTTACTGACTGGTTTGCTCTTCTTCGCAAAGACTGCGTGTGCTCTTTATTGAGTGTGCGTAGGATTTACGACGTTTACTTTGAAAAAATTAGAGTGTTCAAAGCAGGCTATTGCTTGAATACATGAGCATGGAATAATGGAATAGGACTTTGGTCCCATTTTGTTGGTTTCTAGGGCCGAATTGGATTTACGAAAGACGAACAACTGCGAAAGCACTTGCCAAGAGTGTTT
ASV352	AGCTCCAATAGCGTATATTAAAGTTGTTGCAGTTAAAAAGCTCGTAGTTGGATTTCGGAGTGGGCCAGTTGGTCCGCCGCAAGGTGTGTTACTGACAAAATTAGAGTGTTCAAAGCAGGCTATTGCTTGAATACATGAGCATGGAATAATGGAATAGGACTTTGGTCCCATTTTGTTGGTTTCTAGGACCGAAGTAATGATTAAGAGGGACAATTGGGGGCATCCGTATTTCGTTGTCAGAGGTGAAATTCTTGGATTTACGAAAGACGAACAACTGCGAAAGCACTTGCCAAGAGTGTTT
ASV353	ACAAGTAGAACCAGGTTTGCCACCAGTAACTGTGAGTGGGCTGAAATATGGTCTCAGGGGCGCTTATCACTCTAAAATCCTGGGACCAGGCATACAGTCATCCCTGGCCAGGGCCCTGGTGGAGGCGGCCAACCATATGGCCACCTTCACCTGGAGGGCGTACTCGTCCGTATGGAAGCAGGTGGGGAAGCTGGGCAGGGAGGCGGGGATTGAGTACAAGCTGCCGATGACCAGGGACATGGTGAGAGGCATAGTGGGGGCA
ASV354	AGCACTTGCTAGTGCTACTGCCCTATAGACCGTAGTTTTGCCAGAGGTCTCAGGGTGCTCTTAATCGAGTGTCTTGTGATGCTGGCAGGTCTACTTTGAAAAAATTAGAGTGCTCAAAGCAGGCTTTTACGCCTGAATATTCGTGCATGGAATAATAGAATAGGAAGTCGTTTCTATTTTGTTGGTTTTCGGAAATCGACTTAATGATTAATAGGGACAGTCGGGGGCATTTGTATTCAAACGACAGAGGTGAAATTCTTGGACCGTTTGAAGACAAACTACTGCGAAAGCATTTGCCAAGAATGTTT
ASV355	AGCTCCAATAGCGTATATTAAAGTTGTTGTGGTTAAAAAGCTCGTAGTTGGATCTCGGCGGACTGAGGGCGGTTTGCTTGCTAGTATTACTGCCCTATAGTCCGTAGTTTTGCCAGAGGTTTCGGGGTGCTCTTAATCGAGTGTCCCGGGATGCTGGCAGGTTTACTTTGAAAAAATTAGAGTGCTCAAAGCAGGCTATTACGCTTGAATATTCGTGCATGGAATAATAGAATAGGAAGTTGTTTCTATTTTGTTGGTTTTCGGAAATCGACTTAATGATTAATAGGGACAGTCGGGGGCATTTGCCAAGAATGTTT
ASV356	ACAAGCGGTTAACTTTGTAGTTTTACTGCTTTATAGGCTGTGCTTTTGCTGGAGGTTTAGGGGTGCTCTTGATCGAGTGTCTCTGGATGCCAGCAGGTTTACTTTGAAAAAATTAGAGTGCTCAAAGCAGGCTAAAATGCCTGAATATTCGTGCATGGAATAATAGAATAGGATGTCGATCCTATTTTGTTGGTTTTCGGGACTCGACATAATGATAAATAGGGACAGTCGGGGGCATTTGTATTCAAACGACAGAGGTGAAATTCTTGGACCGTTTGAAGACAAACTACTGCGAAAGCATTTGCCAAGAATGTTT
ASV357	TGCAAAGAATGGTTTGGTCACAGGGTTGGGAAAGTGAGTTACTTCAGACTAAGAGCCACAAAACACAGCCAAGGTGCCACACTCAATCCTGCTAAAAAATTGGCTTGGCCACATGGTTGGGAGAGGGAGTTACGTAAGACTAAGAGCCACAAAACACAGCCCAGGTGCCACACTCACTCCTGCAAATATTGGTTTGGCCACAGAGTTGGGAGAGGGAGATACCTAGGCTAAGAGCATACCCTGACAAGCAGCACTTTTTC
ASV358	AGCTCCAATAGCGTATATTAAAGTTGTTGTGGTTAAAAAGCTCGTAGTTGGATCTCAACAGCCTTGAAGCGGTTAACTTTGTAGTTTTACTGCTTTATAGGCTGTGCTTTTGCTGGAGGTTTAGGGGTGCTCTTGATCGAGTGTCTCTGGATGCCAGCAGGTTTACTTTGAAAAAATTAGAGTGCTCAAAGCAGGCTAAAATGCCTGAATATTCGTGCATGGAATAATAGAATAGGATGTCGTGAAATTCTTGGACCGTTTGAAGACAAACTACTGCGAAAGCATTTGCCAAGAATGTTT
ASV359	AGCTCCAATAGTTGTTATATTAAAGCTGTTGTGGTTAAAAAGCTCGTAGTTGGATCTCGGCGGACTGAGGCCGGTTTGCTTACTAGTATTACTGCCCTATTGTCCGTAGTTTTTGCCAGAGTTTTTGGGGTGCTCTTAATCGAATGTTTCAGGATGCTGGCAGAGTTACTTTGAAAAATTAGAGCGCTCAAAGCAGTCTATTAAGCCTGAATATTCGTGCATAGAATAATAGAATAGGAAGTTGTCTCAAACAACAGAGCTGAAATTCTTGGACCGTTTGAATACAATCTACTGCGAAAGCATTTGCCAAGAATGTTT
ASV360	AGCTCCAATAGCGTATATTAAAGTTGTCGCAGTTAAAAAGCTCGTAGCTGGATTTCGGATGTTCAAAGCAGGCTATTGCTTGAATACATGAGCATGGAATAATGGAATAGGACTTTGGTCCCATTTTGTTGGTTTCTAGGACCGAAGTAATGATTAAGAGGGACAATTGGGGGCATCCGTATTTCGTTGTCAGAGGTGAAATTCTTGGATTTACGAAAGACGAACAACTGCGAAAGCACTTGCCAAGAGTGTTT
ASV361	AGCTCCAATAGCGTATATTAAAGTTGTTGCAGTTAAAAAGCTCGTAGTTGGATTTCGGAGTGAGCTAGTTGGTACGACGTTGGTACGACGTTTACTTTGAAAAAATTAGAGTGTTCAAAGCAGGCTATTGCTTGAATACATGAGCATGGAATAATGGAATAGGACTTTGGTCCCATTTTGTTGGTTTCTAGGACCGAAGTAATGATTAAGAGGGACAATTGGGGGCATCCGTATTTCGTTGTCAGAGGTGAAATTCTTGGATTTACGAAAGACGAACAACTGCGAAAGCACTTGCCAAGAGTGTTT
ASV362	TCAGATCTGGACTGTGAGGGTCTACACAGCTGTGCAGTTTGTAACCCCCTCCACCAACTTCTTTACCAAAGTTCTAACTCTTCTTCATTTCCAGATAAAGAAAACGAATCCGCCATGTCTGATCATCATGATGAACTAGAGCTCACTCTGGATGAATCTTAGATGATCGATATGACGAAGTCTGAGGCAGAGGATGTCCCTGTTGTCATTGAGCCAACCGGCTCTAACAGCAACAAACTTCCTCACCGCCCAGCCGCCCAAAGC
ASV363	AGCTCCAATAGCGTATATTAAAGTTGTTGCAGTTAAAAAGCTCGTAGTTGGATTTCGGAGTGGGCCAGTTGGTCCGCCGCAAGGTGTGTTACTGACTGGTTTGCTCTTCTTCGCAAAGACTGCGTGTGCTCTTGAGTGAGTGTGCGTAGGATTTACGACGTTTACTTTGAAAAAATTAGAGTGTTCAAAGCAGGCTATTGCTTGAATACATGAGCATGGAATAATGGAATAGGACTTTGGTCCCATTTTGTTGGTTTCTAGGACCGAAGTAATGATTAAGAGGGACAATTGAGTGTTT
ASV364	AGCTCCAATAGCGTATATTAAAGTTGTTGCAGTTAAAAAGCTCGTAGTTGGATTTCGGAGTGGGCCAGTTGGTCCGCCGCAAGGTGTGTTACTGACTGGTTTGCTCTTTACTTTGAAAAAATTAGAGTGTTCAAAGCAGGCTATTGCTTGAATACATGAGCATGGAATAATGGAATAGGACTTTGGTCCCATTTTGTTGGTTTCTAGGACCGAAGTAATGATTAAGAGGGACAATTGGGGGCATCCGTATTTCGTTGTCAGAGGTGAAATTCTTGGATTTACGAAAGACGAACAACTGCGAAAGCACTTGCCAAGAGTGTTT
ASV365	AGCTCCAATAGCGTATATTAAAGTTGTGTGGTTAAAAAGCTCGTAGTTGGAGGCCTCGGGGTGCTCTTAACCGAGTGTCCTGCGGCGCTGGCGGGTTTACTTTGAAAAAATTAGAGTGCTCAAAGCAGGCTTTTACGCCTGAATATTCGTGCATGGAATAATAGAATAGGAGGTCGTTTCTATTTTGTTGGTTTTCGGAAATCGACTTAATGATTAATAGGGATAGTTGGGGGCATTTGTATTCAAACGACAGAGGTGAAATTCTTGGACCGTTTGAAGACAAACTTCTGCGAAAGCATTTGCCAAGAATGTTT
ASV366	AGCTCCAATAGCGTATATTAAAGTTGTGTGGTTAAAAAGCTCGTAGTTGGAGGCCTCGGGGTGCTCTTAACCGAGTGTCCTGCGGCGCTGGCGGGTTTACTTTGAAAAAATTAGAGTGCTCAAAGCAGGCTTTTACGCCTGAATATTCGTGCATGGAATAATAGAATAGGATGTCGATCCTATTTTGTTGGTTTTCGGGACTCGACATAATGATAAATAGGGACAGTCGGGGGCATTTGTATTCAAACGACAGAGGTGAAATTCTTGGACCGTTTGAAGACAAACTACTGCGAAAGCATTTGCCAAGAATGTTT
ASV367	AGCTCCAATAGCGTATATTAAAGTTGTTGCGGTTAAAAAGCTCGTAGTTGGATCTCGGCAAGTAGAGGGCGGTATGCTTCGTAGCATTACTGCCCTATTACTTGTAGTTTTGCCAGAGGTTCCTGGGTGCTCTTAATCGAGTGTCTAGGGATGCTGGCAGGTTTACTTTGAAAAAATTAGAGTGCTCAAAGCAGCTATTACGCCTGAATATTCGTGCAAAAGGAACACTCGGGGGCATTTGTATTCAAACGACAGAGGTGAAATTCTTGGACCGTTTGAAGACAAACTACTGCGAAAGCATTTGCCAAGAATGTTT
ASV368	AGCTCCAATAGCGTATATTAAAGTTGTTGTGGTTAAAAAGCTCGTAGGCTCGGTCGGGGTTGCTCTTCATCGAGTGTCCCGGGCGTCCGGCATGTTTACTTTGAAAAAATTAGGGTGCTCAGAGCAGGCCAAGGCGCCTGAATACTTGTGCATGGAATAATGGAATAGGACCTCGGTTCTATTTTGTTGGTTTTAAGAGCCCGAGGTAATGATTAACAGGAACAGACGGGGGCATCCGTATTGCGACGTTAGAGGTGAAATTCTTGGACCGTCGCAAGACGAACGACTGCGAAAGCATTTGCCAAGGATGTTT
ASV369	AGCTCCACTAGCATATATTAAAGTTGTTGCGGTTAAACAGCTCGTAGTTGGATCTTCATCGAGTGTCCCGGGCGGCCGGCACGTTTACTTTGAAAAAATTAGGGTGCTCAGAGCAGGCCAAGGCGCCTGAATACTTGTGCATGGAATAATGGAATAGGACCTCGGTTCTATTTTGTTGGTTTTCGGAACTTGAGGTAATGATAAAGAGGGACAGACGGGGGCATTCGTATTACGGTGTTAGAGGTGAAATTCTTGGATCGCCGTAAGACGAACTACTGCGAAAGCATTTGCCAAGCATGTTTTCC
ASV370	AGCTCCAATAGCGTATATTAAAGTTGTTGTGGTTAAAAAGCTCATAGTTGGATCTCAGCTCCAGACCGACGGTACGCCACCCAGCGTCTACTGTCTGCTTCCAAACTTTGAAAAAATGAGGGTGCTCAGAGCAGGCCAAGGCACCTGAAAACTTGTGCATGGAATAATGGAATAGGACCTCGGTTCTATTTTGTTGGTTTTAAGAGCCCGAGGTAATGATTAATAGGAACAGACGGGGGCATTCGTATTGCGACGTTAGAGGTGAAATTCTTGGATCGTCGCAAGACGAACTACTGCGAAAGCATTTGCCAAGAATGTTT
ASV371	AGCTCCAATAGCGTATATTAAAGTTGTTGTGGTTAAAAAGCTCATAGTTGGATCTCAGCTCCAGACCGACGGTACGCCACCCAGCGTCTACTGTCTGCTTCCAAACTTTGAAAAAATGAGGGTGCTCAGAGCAGGCCAAGGCACCTGAAAACTTGTGCATGGAATAATGGAATAGGACCTCGGTTCTATTTTGTTGGTTTTAAGAGCCCGAGGTAATGATTAATAGGAACAGACGGGGGCATTCGTATTGCGACGTTAGAGGTGAAATTCTTGGACCGTTTGAAGACAAACTACTGCGAAAGCATTTGCCAAGAATGTTT
ASV372	AGCTCCAATAGCGTATATTAAAGTTGTTGTGGTTAAAAAGCTCATAGTTGGATCTCAGCTCCAGACCGACGGTACGCCACCCAGCGTCTACTGTCTGCTTCCAAACTTTGAAAAAATGAGGGTGCTCAGAGCAGGCCAAGGCACCTGAAAACTTGTGCATGGAATAATGGAATAGGATGGTACTCGGTTCGATTTGTTGGTTTAAGAGCCAGAAGTAATGATTACGAGAAACAGACGGGGCATTTGTTTTGTGACGTTAGAGGTGAAATTCTTGGATTGTCGAAGATGAATGACGGCGAAAGCATTCGCCAAGAGTGTTT
ASV373	AGCTCCAATAGCGTATATTAAAGTTGTTGCGGTTAAAAAGCTCGTAGTTGGATCTCGGCAAGTAGAGGGCGGTATGCTTCGTAGCATTACTGCCCTATTACTTGTAGTTTTGCCAGAGGTTCCTGGGTGCTCTTAATCGAGTGTCTAGGGATGCTGGCAGGTTTACTTTGAAAAAATTAGAGTGCTCAAAGCAGGCTATTACGCCTGAATTTTTCGTGCATGGAATAATAGAATAGGAAGTCGTTTCTATTTTGTTGGTTTTCGGAAATCGACTTAATGTTTGAAGACAAACTACTGCGAAAGCATTTGCCAAGAATGTTT
ASV374	AGCTCCAATAGCGTATATTAAAGTTGTTGTGGTTAAAAAGCTCGTAGTTGGATCTCGGCGGACTGAGGGCGGTTTGCTTGCTAGTATTACTGCCCTATAGTCCGTAGTTTTGCCAGAGGTTTCGGGGTGCTCTTAATCGAGTGTCCCGGGATGCTGGCAGGTTTACTTTGAAAAAATTAGAGTGCTCAAAGCAGGCTATTACGCCTGAATTTTTCGTGCATGGAATAATAGAATAGGAAGTCGTTTCTATTTTGTTGGTTTTCGGAAATCGACTTAATGTTTGAAGACAAACTACTGCGAAAGCATTTGCCAAGAATGTTT
ASV375	AGCTCCAATAGCGTATATTAAAGTTGTTGTGGTTAAAAAGCTCGTAGTTGGATCTCGGCGGACTGAGGGCGGTTTGCTTGCTAGTATTACTGCCCTATTAGAGTGCTCAAAGCAGGCTATTACGCCTGAATATTCGTGCATGGAATAATAGAATAGGAAGTCGTTTCTATTTTGTTGGTTTTTAAGTTTCGACTTAATGATTAATAGGGACAAACGGGGGCATTTGTATTCAAACGACAGAGGTGAAATTCTTGGACCGTTTGAAGACAAACTACTGCGAAAGCATTTGCCAAGAGTGTTT
ASV376	AGCTCCAATAGCGTATATTAAAGTTGTTGCGGTTAAAAAGCTCGTAGTTGGATCTCAGTTCCGGACCGACGGTACGCCGCCCGGCGTCTACTGTCGGCTTCCGAACGCTAAAGCCCGTCGGCTCGGTCGGGGTGCTCTTCATTGAGTGTCCCGGGCGGCCGGCATGTTTACTTTGAAAAAATTAGGTTTTAAGAGCCCGAGGTAATGATTAATAGGAACAGACGGGGGCATTCGTATTGCGACGTTAGAGGTGAAATTCTTGGATCGTCGCAAGACGAACTACTGCGAAAGCATTTGCCAAGAATGTTT
ASV377	AGCTCCAATAGCGTATATTAAAGTTGTTGCGGTTAAAAAGCTCGTAGTTGGATCTCAGTTCCGGACCGATGGTACGCCGCATGTTTACTTTGGAAAAATTAGGGTGCTCAGAGCAGGCCAAGGCGCCTGAATACTTGTGCATGGAATAATGGAATAGGACCTCGGTTCTATTTTGTTGGTTTTAAGAGCCCGAGGTAATGATTAATAGGAACAGACGGGGGCATTCGTATTGCGACGTTAGAGGTGAAATTCTTGGATCGTCGCAAGACGAACTACTGCGAAAGCATTTGCCAAGAATGTTT
ASV378	AGCTCCAATAGCGTATATTAAAGTTGTTGTGGTTAAAAAGCTCATAGTTGGATCTCAGCTCCAGACCGACGGTACGCCACCCAGCGTCTACTGTCTGCTTCCAAACTTTGAAAACATGAGGGTGCTCAGAGCAGGCCAAGGCACCTGAAAACTTGTGCATGGAATAATGGAATAGGACCTCGGTTCTATTTTGTTGGTTTTAAGAGCCCGAGGTAATGATTAATAGGAACAGACGGGGGCATTCGTATTGCGACGTTAGAGGTGAAATTCTTGGATCGTCGCAAGACGAACTACTGCGAAAGCATTTGCCAAGAATGTTT
ASV379	AGCTCCAATAGCGTATATTAAAGTTGTTGCAGTTAAAAAGCTCGTAGTTGGATCTCAGTTCCGGACCGACGGTACGCCGCCCGGCGTCTACTGTCGGCTTCCGAACGCTAAAGCCCGTCGGCTCGGTCGGGGTGCTCTTCATCGAGTGTCCCGGGCGGCCGGCATGTTTACTTTGAAAAAATTAGGGTGCTTAGAGGAGGCCAAGGCGCCTGAATACTTGTGCATGGAATAATGGAATAGGACCTCGGTTCTATTTTGAAATTCTTGGATTGTTGCAAGACGAACTACTGCGAAAGCATTTGCCAAGAATGTTT
ASV380	AGCTCCAATTGCTTGCTAGTATTACTGCCCTATAGTCCGTAGTTTTGCCAGAGGTTTTGCGGTGCTCTTAATCGAGTGTCCTGGGATGCTGGCAGGTTTACTTTGAAAAAATTAGAGTGCTCAAAGCAGGCTATTACGCCTGAATATTCATGCATGGAATAATAGAATAGGAAGTTGTTTCTATTTTGTTGGTTTTCGGAAATCGACTTAATGATTAATAGGGACAGTCGGGGGCATTTGTATTCAAACGACAGAGGTGAAATTCTTGGACCGTTTGAAGACAAACTACTGCGAAAGCATTTGCCAAGAATGTTT
ASV381	AGCTCCAATAGCGTATATTAAAGTTGTTGCGGTTAAAAAGCTCGTAGTTGGATCTCAGTTCCGGACCGACGGTACGCCGCCCGGCGTGTACTGTCGGCTTCCGAACGCTAAAGCCCGTCGGCTCGGTCGGGGTTGCTCTTCATCGAGTGTCCCGGGCGGCCGGCATGTTTACTTTGAAAAAATTAGGGTGCTTAGAGGAGGCCAAGGCGCCTGAATACTTGTGCATGGAATAATGGAATAGGACCTCGGTTCTATTTTGAAATTCTTGGATTGTTGCAAGACGAACTACTGCGAAAGCATTTGCCAAGAATGTTT
ASV382	AGCTCCAATAGCGTATATTAAAGTTGTTGCGGTTAAAAAGCTCGTAGTTGGATCTCAGTTCCGGACCGACGGTACGCCGCCCGGCGTCTACTGTCGGCTTCCGAACGCTAAAGCCCGTCGGCTCGGTCGGGGTGCTCTTCATCGAGTGTCCCGGGCGGCCGGCATGTTTACTTTGAAAAAATTAGGGTGCTTAGAGGAGGCCAAGGCGCCTGAATACTTGTGCATGGAATAATGGAATAGGACCTCGGTTCTATTTTGAAATTCTTGGATTGTTGCAAGACGAACTACTGCGAAAGCATTTGCCAAGAATGTTT
ASV383	AGCTCCAATAGCGTATATTAAAGTTGTTGCGGTTAAAAAGCTCGTAGTTGGATCTCGGCAAGTAGAGGGCTATTACGCTTGAATATTCGTGCATGGAATAATAGAATAGGAAGTTGTTTCTATTTTGTTGGTTTTCGGAAATCGACTTAATGATTAATAGGGACAGTCGGGGGCATTTGTATTCAAACGACAGAGGTGAAATTCTTGGACCGTTTGAAGACAAACTACTGCGAAAGCATTTGCCAAGAATGTTTTCACTCATCAATAACGAAAGT
ASV384	AGCTCCAATAGCGTATATTAAAGTTGTTGCGGTTAAAAAGCTCGTAGTTGGATCTCAGTTCCGGACCGACGGTACGCCGCCCGGCGTCCGGCATGTTTACTTTGAAAAAATTAGGGTGCTCAGAGCAGGCCAAGGCGCCTGAATACTTGTGCATGGAATAATGGAATAGGACCTCGGTTCTATTTTGTTGGTTTTAAGAGCCCGAGGTAATGATTAACAGGAACAGACGGGGGCATCCGTATTGCGACGTTAGAGGTGAAATTCTTGGACCGTCGCAAGACGAACTACTGCGAAAGCATTTGCCAAGAATGTCT
ASV385	AGCTCCAATAGCGTATATTAAAGTTGTTGCGGTTAAAAAGCTCATAGTTGGATCTCAGCTCCAGACCGACGGTACGCCACCCAGCGTCTACTGTCTGCTTCCAAACTTTGAAAAAATGAGGGTGCTCAGAGCAGGCCAAGGCACCTGAAAACTTGTGCATGGAATAATGGAATAGGACCTCGGTTCTATTTTGTTGGTTTTAAGAGCCCGAGGTAATGATTAATAGGGACAGTCGGGGGCATTTGTATTCAAACGACAGAGGTGAAATTCTTGGACCGTTTGAAGACAAACTACTGCGAAAGCATTTGCCAAGAATGTTT
ASV386	AGCTCCAATAGCGTATATTAAAGTTGTTGTGGTTAAATAGCTCATAGTTGGATCTCAGCTCCAGACCGACGGTACGCCACCCAGCGTCTACTGTCTGCTTCCAAACTTTGAAAAAATTAGGGTGCTCAGAGCAGGCCAAGGCACCTGAAAACTTGTGCATGGAATAATGGAATAGGACCTCGGTTCTATTTTGTTGGTTTTAAGAGCCCGAGGTAATGATTAATAGGAACAGACGGGGGCATTCGTATTGCGACGTTAGAGGTGAAATTCTTGGATCGTCGCAAGACGAACTACTGCGAAAGCATTTGCCAAGAATGTTT
ASV387	AGCTCCAATAGCGTATATTAAAGTTGTTGTGGTTAAAAAGCTCATAGTTGGATCTCAGCTCCAGACGGACGGTACGCCAAGCAGCGTCTACTGTCTGCTTCCAAACTTTGAAAAAATCAGGGTGCTCAGAGCAGGCCAAGGCATCTGAAAACTTGTGCATGGAATAATGGAATAGGACCTCGGTTCTATTTTGTTGGTTTTAAGAGCCCGAGGTAATGATTAATAGGAACAGACGGGGGCATTCGTATTGCGACGTTAGAGGTGAAATTCTTGGATCGTCGCAAGACGAACTACTGCGAAAGCATTTGCCAAGAATGTTT
ASV388	AGCTCCAATAGCGTATATTAAAGTTGTTGCAGTTAAAAGGCTCGCTAGCTATTGCTTGAATACATGAGCATGGAATAATGGAATAGGACTTTGGTCCCATTTTGTTGGTTTCTAGGACCGAAGTAATGATTAAGAGGGACAATTGGGGGCATCCGTATTTCGTTGTCAGAGGTGAAATTCTTGGATTTACGAAAGACGAACAACTGCGAAAGCACTTGCCAAGAGTGTTT
ASV389	AGCTCCAAAAGCGTATATTAAAGTTGTTGTGCTTAAAAAGCTAATTTTGCCAGAGGTTTCGGGGTGATCTTAATCAAGTGTCCCGGGATGCTGGCAGATTTACTTTGAAAAAATTAGAGTGCTCAAAGCAGGCTATTACGCCTGAATATTCGTGCATGGAATAATAGAATAGGAAGTTGTTTCTATTTTGTTGGTTTTCGGAAATCGACTTAATGATTAATAGGGACAGTCGGGGGCATTTGTATTCAAACGACAGAGGTGAAATTCTTGGACCGTTTGAAGACAAACTACTGCGAAAGCATTTGCCAAGAATGTTT
ASV390	CCAGCAGCAGAGGGAATTCCAGCTCCAATAGCGTATATTAAAGTTGTTGTGGTTAAAAAGCTCGTAGTTGGATCTCGGCGGACTGAGGGCGGTTTGCTTGCTAGTATTACTGCCCTATAGTCCGTAGTTTTGCCAGAGGTTTCGGGGTGCTCTTAATCGAGTGTCCCGGGATAGGGACAGTCGGGGGCATTTGTATTCAAACGACAGAGGTGAAATTCTTGGACCGTTTGAAGACAAACTACTGCGAAAGCATTTGCCAAGAATGTTTTCA
ASV391	AGCTCCATTAGTATATATCATTGTTGTTGTGGTTAAAAAGCTCGTAGTTGGATCTCTTCGGTTTTAGATCGGTTCACTTTTTGGGTGCTACTGATCTATAGGCCGTACTTTTGTCAGAGGTCTCAGGGTGCTCTTAATCGAGTGTCTTGTGATGCTGGCAGGTTTACTTTGAAAAAATTAGAGTGCTCAAAGCAGGCTATTACGCTTGAATATTCGTGCATGGAATAATAGAATAGGAAGTTGTTTCTATTTTGTTGGTTTTCGGAAATCGACTTAATGATTAATAGGGACAGTCGGGGGCATTTGCCAAGAATGTTT
ASV392	AGCTCCAATAGCGTATATTAAAGTTGTTGCAGTTAAAAAGCTCGTAGTTGGATTTCGGAGTGGGCCAGTTGGTCCGCCGCAAGGTGTGTTACTGACTGGTTTGCTCTTCTTCGCAAAGACTGCGTGTGCTCTTGAGTGAGTGCGCGTAGGATTTACGACGTTTACTTTGAAAAAATTAGAGTGTTCAAAGCAGGCTATTGCTTGAATACATGAGCATGGAATAATGGAATAGGACTTTGGTCCCATTTTGTTGGTTTCTAGGGCCGAATTGGATTTACGAAAGACGAACAACTGCGAAAGCACTTGCCAAGAGTGTTT
ASV393	AGCTCCAATAGCGTATATTAAAGTTGTTGTGGTTAAAAAGCTCGTAGTTGGATCTCGGCGGTCTGAGGGCGGTTCACTTGCTAGTGCTACTGCCCTATAGACCGTAGTTTTGTCAGAGGTCTCAGGGTGCTCTTAATCGAGTGTCCTGTGATGCTGGCAGGTTTACTTTGAAAAAATTAGAGTGCTCAAAGCAGGCTATTACGCCTGAATATTCGTGCATGGAATAATAGAATAGGAAGTCGTTTCTATTTTGTTGGTGAAATTCTTGGACCGTTTGAAGACAAACTACTGCGAAAGCATTTGCCAAGAATGTTT
ASV394	AGCTCCAATAGCGTATATTAAAGTTGTTGTGGTTAAAAAGCTCGTAGTTTTGCCAGAGGTTTCGGGGTGCTCTTAATCGAGTGTCCCGGGATGCTGGCAGGTTTACTTTGAAAAAATTAGAGTGCTCAAAGCAGGCTATTACGCCTGAATATTCGTGCATGGAATAATAGAATAGGAAGTCGTTTCTATTTTGTTGGTTTTTAAGTTTCGACTTAATGATTAATAGGGACAGTCGGGGGCATTTGTATTCAAACGACAGAGGTGAAATTCTTGGACCGTTTGAAGACAAACTACTGCGAAAGCATTTGCCAAGAATGTTT
