ASV1	GGTACAGGTTGAACTGTTTACCCCCCTCTTTCAAGAAATATTCCAGTTTTAGCTGGAGCTATTATTATGTTACTAACAGACCAAAACCTAAACACATCTTTTTATGATGTAGGTTGGGGTGGAGATCCTATCTTATACCAATATATTTTTTTTTGGTTCTTTGGTCACCCTGAAGT
ASV2	GGAACTGGTTGAACTGTTTATCCCCCACCAACTTCCCACCATTTACCTCCAGACCAAGTTTCAGCTGCTTTAGCCAAGGCCTCAGATTCAAATGGCTCGTCAGGGTTTCCCGGAACAGTAAAGAATCTCCACAACATGGACCCATCTTGAACGTCATAGGCAGAGATATAACCTCGAACGCCATACTCACCACCTCCATTACCAATAATGATTTTTCCGTCAATGATTCTTTGGTCACCCTGAAGT
ASV3	GGTACTGGTTGAACAGTTTATCCCCCGTGAAATGTAATGTCAGTCAATGAGATTTATCAAAATTCCTAGAATAAAAGCATCATGTCATACTGGTCCTTCTTTATCCTGTCTAGTAAAAAATTTCATTTTAAGCATCCATAGTCTTTTTTTTTTGGCTTCAATTCTTTCATAGTACTCATATGATTCTTTGGTCACCCTGAAGT
ASV4	GGAACTGGTTGAACAGTTTACCCTCCGTCAATTGCTTGTTTTCTTCCTTTTTCATTTACAATCAATAATTTTTTCTTTCTATCTGCTTCTATTATTCTTGCATCAACTCCAGATAGTCCTATCGCATTAATTCCGTTTTTTTGTAACATTTGAACAATTGTTTTGTTTATTCTACCTGACATCACCATTGTAAAAATTTCGGCAGTTTCTTTGTCTGTATATCTGCTCTTAATTCCACTTGGGGATGTTACAAACTTTGGTTCTTTGGTCACCCTGAAGT
ASV5	GGAACTGGATGAACTGTTTATCCTCCGGCTGTGTTTTTTGACCCCTCTTTTTCTTAGTTCCCCCCCTTCTCAGAGAGCCGAGGACTTCGGAACCATTCTCGCCGGTGGCTTTGGGGCTTCTGTTATGACGAAAGGTGGAGGTGTTTCGCCGTGGTTTTTCCTGGGTTTCCTCTGCGACCGTTATTTTTTGTGATTCTTTGGTCACCCTGAAGT
ASV6	GGAACTGGATGAACTGTTTATCCTCCGTGAAATGTAATGTCAGTCAATGAGATTTATCAAAATTCCTAGAATAAAAGCATCATGTCATACTGGTCCTTCTTTATCTTGTCTAGTAAAAAATTTCATTTTAAGCATCCATAGTCTTTTTTTTTGGCTTCAATTCTTTCATAGTACTCATATGGTTCTTTGGTCACCCTGAAGT
ASV7	GGTACTGGATGAACTGTTTATCCTCCAACTCTTGCGCAACAAGGCAAAGTGGCAAATAGCCCGCACCAACGCCGCCAAAGGCTTCCGGGATCGCGGTGCCTTGCAGCCCAAGCTCCGCCAAACCCTGCCAGACATCGCTGGCCTGCAGGGATTCCCCTTCCATGATCGATCGATGTCGGCTCAAGGGGCTCTTCTCGCTCAAAAATCTGCGAACCTGTTCTTGGATCATTCGATCCTCGCTAGAAAAATCAAAATTCATCGGTGTTTTTATTCCTCGTCAATTGTTTTACTGATTCTTTGGTCACCCTGAAGT
ASV8	GGTACTGGTTGAACAGTTTACCCCCCTCTTTCAAGAAATATTGCCCATGCTGGTGGCTCTGTGGACTTTGCTATTTTTTCTTTACATCTCGCAGGGGTAAGATCTATTTTAGGTGCTGTTAATTTTATTAGTACTCTAGCTATTCTTTTACTCCTTTCTTTACCAGTTTTAGCTGGAGCTATTACTATATTATTGACGGACCGAAACTTAAATACCTCTTTCTACGATGTTGGTGGGGGTGGGGATCCTATCTTATATCAACATCTTTTTTGGTTCTTTGGTCACCCTGAAGT
ASV9	GGTACTGGTTGAACTGTTTATCCCCCGCTTGTGAGTGGCTGGCCTATTCACTGTGCTGGTTGCTGGCAGGTGGCGTTTCATGACTGGGCATACTACCTCAGAGGACTTCCGCACTGAAGGAGGCTGGTTGACAGATACAAGAAAAAGGGTGTGGGGTCAGGCATTTGGATCAATTGTGTTTCTAGTGATGTTCGTGATTTTCAAGTGATTCTTTGGTCACCCTGAAGT
ASV10	GGTACAGGTTGAACTGTTTATCCTCCGGTGTAGGCCTTATGAAAATGCCTTTATTTGTTTGGTCTTGGCTGATTACCGCATATCTTCTTATCGCTGTTATGCCTGTTTTGGCAGGAGCAGTAACAATGATGTTAATGGACATACATTTTGGGACAAGTTTCTTTAATGCAGCTGGCGGCGGCGACCCAGTTCTTTTCCAGCATATATTTTGATTCTTTGGTCACCCTGAAGT
ASV11	GGTACAGGTTGAACTGTATACCCCCCCGGTAATGCGCAATTGGTCCCAGAGGTTATTATTGCAGCCTCCCTAATCTCTATCTATAGCCAGAACTAAGACTCATTTCTGGAACTCATTTTGTCACTCTTATTATCTAAAGTCACAAAGCCTAGGATTTACAGTACAATAAATAAAACAACCTGATGGTTGTTACAATACACAATTACACATACCATAATGCTCCGATTAGTTCGCACGCATACTATTGATTCTTTGGTCACCCTGAAGT
ASV12	GGTACTGGTTGAACTGTTTATCCCCCGCTTGTGAGTGGCTGGCCTATTCACTGTGCTGGTTGCTGGCAGGTGGCGTTTCATGACTGGGCATACTACCTCAGAGGACTTCCGCACTGAAGGAGGCTGGTTGACAGATACAAGAAAAAGGGTGTGGGGTCAGGCATTTGGATCAATTGTGTTTCTAGTGATGTTCGTGATTTTCAAGTGGTTCTTTGGTCACCCTGAAGT
ASV13	GGTACAGGTTGAACTGTATACCCCCCCGGTAATGCGCAATTGGTCCCAGAGGTTATTATTGCAGCCTCCCTAATCTCTATCTATAGCCAGAACTAAGACTCATTTCTGGAACTCATTTTGTCACTCTTATTATCTAAAGTCACAAAGCCTAGGATTTACAGTACAATAAATAAAACAACCTGATGGTTGTTACAATACACAATTACACATACCATAATGCTCCGATTAGTTCGCACGCATACTATTGGTTCTTTGGTCACCCTGAAGT
ASV14	GGTACAGGTTGAACAGTTTACCCCCCTCCAGATCAGGAAAATTTTATGTTTGTTCATATTCATATTCGAGTTCGGCAACTGTCCCCTCAGTTCGAATTACTGAATTGTGTCGAATTCCGTCCGGCAGGATTTAGCCTTGCTCGAGTTCGTTTTGATTCTTTGGTCACCCTGAAGT
ASV15	GGTACTGGTTGAACTGTATACCCTCCGCGATCACTGATAGCCATTGCCATCTGGATTTCCCAGATTTTGCCGATGAGCTTGACACTATAATAAGCCGAGCGCAGGCCGCGGGCGTTCATCGCATGGTAACGATTTGTACAAAATTACAGAATGAACCCTCTGTACGCGCCATCGCCGCGCGATATGCACCTGTTTTTTACGCGGCTGGCACCCATCCGATGAGCGCAGCAGATGATTCTTTGGTCACCCTGAAGT
ASV16	GGAACAGGTTGAACAGTTTATCCCCCGCTATTATTTCTATTTTTTCTGTTTACGCCGATGACGCCTTTGCCAAATCCTCCACTACTTGTCCTTGATCGGTTGCGGTCATTCGTTTTATCTCTTCCTGAGGATCGATAAGAGTCATCTTTTTTACTATGCTCCTTCCTTGATTTTCGATCATTTAAGCTTTCTGTTTGATTCTTTGGTCACCCTGAAGT
ASV17	GGTACAGGTTGAACTGTTTACCCCCCTGGCATGTTTTCTACTGATGGAATAATTCCAACTACGTTAATTGGTAATTTTAATTCTGAAACTGATTTCATAATTCCTAACACTGTACATCCTCCACATTTATCAAACTTCATTTCATCCATACTTTGTCCTGGCTTTAATGAAATTCCACCAGTATCAAATGTGACCGCCTTTCCAACTAAAACAATTGGTTTTTGATTCTTTGGTCACCCTGAAGT
ASV18	GGTACAGGTTGAACAGTTTATCCTCCTCCGCAGTCCGAATGGCCGCACGGGCCGGCGACCATTATTCAGAAATTGCTAGCCTCGTTTTGTTTTCCATTTGCTTGTGTTTGCTTTTTGATAGGTGTTCGTTTGGCTTTTGCTTGTGTTGTTCTTTGTTTGTTGCTTCTGTTAGTTTATTGATGGTTCTTTGGTCACCCTGAAGT
ASV19	GGTACTGGATGAACTGTTTATCCTCCTTTTCCCAAAATCCACTTCATTTTCATTTCCATTTTCATTTTCATTTTCATTTTCATTTTCATTTTTCATTTTCATTCTCATTTTCATTTTCATTTTCATTTTCATTTCCATTTTTCATTTTCGTTTTCATTTCATTTTCATTTTCATTTTCATTTTCATTTTCATTTTCATTTTCTTTTTGTTGGTGATTCTTTGGTCACCCTGAAGT
ASV20	GGTACAGGTTGAACTGTTTACCCCCCAGTGGTTCCATCCAGTGGAAAGATGTTACACATTTCAGTGCTGTCCCAGAACGAACCTGCGTTGATGATTTCTTTGGCATGTGAATTCCTCAGTTCCTCCTCACTCCTTGGCTTGTAATTGATTGGAGTATAATGCCTATTGAGATTATTTGGTTGTGTTGGAGAAAACACCGTGTCGTCATTGTCATTGTTGGGATAGTTGTTGGGGTCGTCGTGATTTTTTGGTCACCCTGAAGT
ASV21	GGTACTGGATGAACAGTATACCCCCCATATACCATTTACGTCTAAAGTAGGTCTAATGCTCATTCTCTCATATGGAGTATAATCGGACTCCCCTTCATGCGCACCTATATCAATACTTGCTTTATGTGTTTCCTCAGAAAAAGGAGCCCTTGCCATAGCCGCTCTTTCATCGGAAGTGAGTTCTAAGACGTCGTCGTAGAATCCATCGACTGTGATTCTTTGGTCACCCTGAAGT
ASV22	GGTACAGGTTGAACTGTTTATCCTCCGGTGTAGGCCTTATGAAAATGCCTTTATTTGTTTGGTCTTGGCTGATTACCGCATATCTTCTTATCGCTGTTATGCCTGTTTTGGCAGGAGCAGTAACAATGATGTTAATGGACATACATTTTGGGACAAGTTTCTTTAATGCAGCTGGCGGCGGCGACCCAGTTCTTTTCCAGCATATATTTTGGTTCTTTGGTCACCCTGAAGT
ASV23	GGTACAGGTTGAACTGTTTATCCCCCAAATCCCAAAAATTCCAAGAATATCAAAATCACTACCCAAAATGCTAGAATCACAATTAGATCCACTAAAATCAATGAAAAACACAAAAAATGTTAAAACAAACACAAAATCAAAGGGAAAACGACCTAAGGCCAAAGTTAGTTCCCACAACGCTTGCCGTTTTGGGTATCCTTTCTTCCTGTCCCCGAGTGATGACGATGCAATGCTGGAAATCCCAAATCCCACCCCCTCTGTCCACCAGACTCCAGGTTGTTGTTGTTGGTTCTTTGGTCACCCTGAAGT
ASV24	GGTACTGGTTGAACTGTTTATCCCCCGCTTTAAATGTTCTGCAAGAGAGCGGATTTTTCCCCAAGGGTTATAAGTTGGATGACACCAACAATTTAAAATTAGATGGTTTAACAGCTGAAGGAATCATGGGCAATCTTAACTCATTAAATGGGAAGCCTTCGGTTTTTAATTTAACCCAAATCATGCAGATGTACCGCGGTAGATATCAATTAAAACCAGTAACTGCTCATGATTCTTTGGTCACCCTGAAGT
ASV25	GGTACTGGTTGAACTGTTTATCCTCCGCGATCACTGATAGCCATTGCCATCTGGATTTCCCAGATTTTGCCGATGAGCTTGACACTATAATAAGCCGAGCGCAGGCCGCGGGCGTTCATCGCATGGTAACGATTTGTACAAAATTACAGAATGAACCCTCTGTACGCGCCATCGCCGCGCGATATGCACCTGTTTTTTACGCGGCTGGCACCCATCCGATGAGCGCAGCAGATGATTCTTTGGTCACCCTGAAGT
ASV26	GGTACAGGATGAACTGTATATCCCCCTGTGAAATTAGCATAGTACGTTGAAATCCGGTCGTATTAGAGCCATCAATTACTGTTTTTCTCATTGGATAAATTTCACTAAAAATATTTGATTTTAAAGCAGAAGAAATAACCAATGAGATTTTTCTAGCATCTTCATCTAATTCATGTGGTGGTTCTTTGGTCACCCTGAAGT
ASV27	GGAACTGGTTGAACAGTTTATCCTCCGCGATCACAGATAGCCATTGCCATCTGGATTTCCCAGATTTTGCCGATGAGCTTGACACTATAATAAGCCGAGCGCAGGCCGCGGGCGTTCATCGCATGGTAACGATTTGTACAAAATTACAGAATGAACCCTCTGTACGCGCCATCGCCGCGCGATATGCACCTGTTTTTTACGCGGCTGGCACCCATCCGATGAGCGCAGCAGATGATTCTTTGGTCACCCTGAAGT
ASV28	GGTACTGGTTGAACTGTATATCCCCCTTTTCCCCAATTCCCGTTCTTTGGCTTTCCCCTTTACCCGTTTTCCAACTTGCAGGTTTTCTCCTTTACTATTTTTTCCTAATATTTTTCTTCCCTCCTTTCTTTTTTCCCCTTAACCAATTTTCCTCTTGAGTGTATATCCCTTTTCTGATTCTTTGGTCACCCTGAAGT
ASV29	GGTACTGGTTGAACTGTTTATCCCCCGCTTGTGAGTGGCTGGCCTATTCACTGTGCTGGTTGCTGGCAGGTGGCGTTTCATGACTGGGCATACTACCTCAGAGGACTTCCGCACTGAAGGAGGCTGGTTGACAGATACAAGAAAAAGGGTGTGGGGTCAGGCATTTGGATCAATTGTGTTTCTAGTGATGTTCGTGATTTTCAAGTGATTTTTTGGTCACCCTGAAGT
ASV30	GGTACTGGTTGAACTGTATACCCTCCGCGATCACTGATAGCCATTGCCATCTGGATTTCCCAGATTTTGCCGATGAGCTTGACACTATAATAAGCCGAGCGCAGGCCGCGGGCGTTCATCGCATGGTAACGATTTGTACAAAATTACAGAATGAACCCTCTGTACGCGCCATCGCCGCGCGATATGCACCTGTTTTTTACGCGGCTGGCACCCATCCGATGAGCGCAGCAGATGGTTCTTTGGTCACCCTGAAGT
ASV31	GGAACAGGTTGAACAGTTTACCCTCCGCTTGTGAGTGGCTGGCCTATTCACTGTGCTGGTTGCTGGCAGGTGGCGTTTCATGACTGGGCATACTACCTCAGAGGACTTCCGCACTGAAGGAGGCTGGTTGACAGATACAAGAAAAAGGGTGTGGGGTCAGGCATTTGGATCAATTGTGTTTCTAGTGATGTTCGTGATTTTCAAGTGATTCTTTGGTCACCCTGAAGT
ASV32	GGAACTGGTTGAACAGTTTATCCTCCTGCGATCACTGATAGCCATTGCCATCTGGATTTCCCAGATTTTGCCGATGAGCTTGACACTATAATAAGCCGAGCGCAGGCCGCGGGCGTTCATCGCATGGTAACGATTTGTACAAAATTACAGAATGAACCCTCTATACGGGCCATCGCAGCGCGATATGCACCTGTTTTTTACGCGGCTGGCACCCATCCGATGAGCGCAGCAGATGATTCTTTGGTCACCCTGAAGT
ASV33	GGTACAGGTTGAACTGTTTATCCTCCGGTGTAGGCCTTATGAAAATGCCTTTATTTGTTTGGTCTTGGCTGATTACCGCATATCTTCTTATCGCTGTTATGCCTGTTTTGGCAGGAGCAGTAACAATGATGTTAATGGACATACATTTTGGGACAAGTTTCTTTAATGCAGCTGGCGGCGGCGACCCAGTTCTTTTCCAGCATATATTTTGATTTTTTGGTCACCCTGAAGT
ASV34	GGTACAGGTTGAACAGTTTATCCCCCGCGATCACAGATAGCCATTGCCATCTGGATTTCCCAGATTTTGCCGATGAGCTTGACACTATAATAAGCCGAGCGCAGGCCGCGGGCGTTCATCGCATGGTAACGATTTGTACAAAATTACAGAATGAACCCTCTGTACGCGCCATCGCCGCGCGATATGCACCTGTTTTTTACGCGGCTGGCACCCATCCGATGAGCGCAGCAGATGATTCTTTGGTCACCCTGAAGT
ASV35	GGTACTGGTTGAACTGTATACCCTCCGCGATCACAGATAGCCATTGCCATCTGGATTTCCCAGATTTTGCCGATGAGCTTGACACTATAATAAGCCGAGCGCAGGCCGCGGGCGTTCATCGCATGGTAACGATTTGTACAAAATTACAGAATGAACCCTCTGTACGCGCCATCGCCGCGCGATATGCACCTGTTTTTTACGCGGCTGGCACCCATCCGATGAGCGCAGCAGATGATTCTTTGGTCACCCTGAAGT
ASV36	GGTACTGGATGAACAGTTTACCCTCCGCGATCACAGATAGCCATTGCCATCTGGATTTCCCAGATTTTGCCGATGAGCTTGACACTATAATAAGCCGAGCGCAGGCCGCGGGCGTTCATCGCATGGTAACGATTTGTACAAAATTACAGAATGAACCCTCTGTACGCGCCATCGCCGCGCGATATGCACCTGTTTTTTACGCGGCTGGCACCCATCCGATGAGCGCAGCAGATGATTCTTTGGTCACCCTGAAGT
ASV37	GGTACAGGTTGAACAGTTTACCCTCCTCTTCTTCCACTGGTTCCTCGGCCTCGACTGGTTCATTGTTGGTCTCATTTTCGAATTCTTTCTCCGCGACCGCAGCTGCGGAGACGCTGGGCTCACTTTCAGTCTCTTCAGGATTTGCCTGAGTGACCTGTTCTGTTCCTTTGTTTTCATCGTCATCAGGTGCTCCAAGCTCGTTTTCCGCCTCTTCCGGGTTGACTTTGGTAGCCTGGCTTTCATCTTTATTGATGTTGTCTCCTGTGAGGATGTCAATCTTGTCGAAGAGTTCCGTTGATTCTTTGGTCACCCTGAAGT
ASV38	GGAACTGGTTGAACAGTTTATCCTCCCGTGAAATGTAATGTCAGTCAATGAGATTTATCAAAATTCCTAGAATAAAAGCATCATGTCATACTGGTCCTTCTTTATCTTGTCTAGTAAAAAATTTCATTTTAAGCATCCATAGTCTTTTTTTTTGGCTTCAATTCTTTCATAGTACTCATATGGTTCTTTGGTCACCCTGAAGT
ASV39	GGTACAGGTTGAACAGTATATCCTCCAAAAAACAATTAAGATTTCAACATTTTTTTGCCCTAGCTTCTAAAAATCCCAAAAAAGTGGTGAAAACAAAAGATAACAGCATAAAGATATTAACTTGATGCTATTTAACACAAAAAAATACATACTTCTATTTTCTGTGATTCATCCACTTTTAGAAGCTAGGGCAAAAAAATGTGAAAAAAATTGTTGATTCTTTGGTCACCCTGAAGT
ASV40	GGTACTGGTTGAACTGTTTATCCCCCTAACGACAGTCAGAGTTGCACTTACTAATTGAATTTGGGATTCCACTCCATAGCAAATATAAAAGATTGACATGGCTTAAATCCAAAGCTGAAATACCAATATTCTATCTGTTTTTTACCTATACTTCACTCTTCCCCTGAACCATTAGAGGATGGTAGACTGGGGTCATGAATATTCACTTTAAATTATTGGTTCTTTGGTCACCCTGAAGT
ASV41	GGAACTGGTTGAACTGTTTACCCTCCGCGATCACTGATAGCCATTGCCATCTGGATTTCCCAGATTTTGTCGATGAGCTTGACAATATAATAAGCCGAGCGCAGGCCGCGGGTGTTCATCGCATGGTAACGATTTGCACAAAATTACAGAATGAACCTTCTGTACGCGCCATCGCCGTGCGATATGCACCTGTTTTTTACGCGGCTGGGACCCATCCGATGAGCGCAGCAGATGGTTCTTTGGTCACCCTGAAGT
ASV42	GGTACTGGTTGAACTGTTTATCCCCCGCTTGTGAGTGGCTGGCCTATTCACTGTGCTGGTTGCTGGCAGGTGGCGTTTCATGACTGGGCATACTACCTCAGAGGACTTCCGCACTGAAGGAGGCTGGTTGACAGATACAAGAAAAAGGGTGTGGGGTCAGGCATTTGGATCAATTGTGTTTCTAGTGATGTTCGTGATTTTCAAGTGGTTTTTTGGTCACCCTGAAGT
ASV43	GGAACAGGTTGAACAGTTTACCCTCCGCTTGTGAGTGGCTGGCCTATTCACTGTGCTGGTTGCTGGCAGGTGGCGTTTCATGACTGGGCATACTACCTCAGAGGACTTCCGCACTGAAGGAGGCTGGTTGACAGATACAAGAAAAAGGGTGTGGGGTCAGGCATTTGGATCAATTGTGTTTCTAGTGATGTTCGTGATTTTCAAGTGGTTCTTTGGTCACCCTGAAGT
ASV44	GGTACAGGATGAACTGTATATCCCCCGCGATCACAGATAGCCATTGCCATCTGGATTTCCCAGATTTTGCCGATGAGCTTGACACTATAATAAGCCGAGCGCAGGCCGCGGGCGTTCATCGCATGGTAACGATTTGTACAAAATTACAGAATGAACCCTCTGTACGCGCCATCGCCGCGCGATATGCACCTGTTTTTTACGCGGCTGGCACCCATCCGATGAGCGCAGCAGATGATTCTTTGGTCACCCTGAAGT
ASV45	GGTACAGGTTGAACTGTTTATCCCCCAAATCCCAAAAATTCCAAGAATATCAAAATCACTACCCAAAATGCTAGAATCACAATTAGATCCACTAAAATCAATGAAAAACACAAAAAATGTTAAAACAAACACAAAATCAAAGGGAAAACGACCTAAGGCCAAAGTTAGTTCCCACAACGCTTGCCGTTTTGGGTATCCTTTCTTCCTGTCCCCGAGTGATGACGATGCAATGCTGGAAATCCCAAATCCCACCCCCTCTGTCCACCAGACTCCAGGTTGTTGTTGTTGATTCTTTGGTCACCCTGAAGT
ASV46	GGTACAGGTTGAACTGTTTATCCTCCTGACCTTCATGCTCTTGTCATTTTTGATGAGTGCTGGTCAATGTTTCTGTACACTGTTCCTCAGATTGAGTTTGCCTGGTGTTTCCCCACCACCCTCCTGTTTGTGCATTTCATGCATGCTCAGGTGTGTCTGATTTTTTGGTCACCCTGAAGT
ASV47	GGTACTGGTTGAACAGTATATCCTCCGTCAATTGCTTGTTTTCTTCCTTTTTCATTTACAATCAATAATTTTTTCTTTCTATCTGCTTCTATTATTCTTGCATCAACTCCAGATAGTCCTATCGCATTAATTCCGTTTTTTTGTAACATTTGAACAATTGTTTTGTTTATTCTACCTGACATCACCATTGTAAAAATTTCGGCAGTTTCTTTGTCTGTATATCTGCTCTTAATTCCACTTGGGGATGTTACAAACTTTGATTTTTTGGTCACCCTGAAGT
ASV48	GGAACTGGATGAACTGTATACCCTCCAAGCTATCATCAGTTGAGTTCTTACCTATTTTAAATTTTGAGCCTATATGAATTGAACTGCCATCATCATTAAATAATGTGAAGTTGAGTACTGATCACAAATTATTTCATGCTATTTGTAAAGTCATATCAAATTATGATTTTTCTGATTCTTTGGTCACCCTGAAGT
ASV49	GGTACTGGTTGAACAGTTTACCCTCCCCCTTTGTTCCTCGTCTTTAATAGCCCTGATGTGCGCCTTCCATCGTTCCCTGGGATCCAGCCCAGAGTCAGGTCTGTCTCCTGCGGGGCCCCACTGCATCCATATCTCCCTATGATACCTCTCAATGGGAGCGAACTCCAGGGGAATCCCTGGATCGTATTTTTGGCGGCATACATAATAGGTCGCCCACATGAAGGCCCCAAGGTACACGTTTCTATCCATCCTGATTTTTTGGTCACCCTGAAGT
ASV50	GGAACTGGTTGAACAGTATACCCTCCGATCACTGATAGCCATTGCCATCTGGATTTCCCAGATTTTGCCGATGAGCTTGACACTATAATAAGCCGAGCGCAGGCCGCGGGCGTTCATCGAATGGTAACGATTTGCACAAAATTACAGAATGAACCTTCTGTACGCGCCATCGCCGTGCGATATGCACCTGTTTTTTACGCGGCTGGCACCCATCCGATGAGCGCAGCAGATGATTCTTTGGTCACCCTGAAGT
ASV51	GGTACTGGATGAACAGTATACCCTCCAATCTGTGTCACCTCTTTCTTCTGTGTAGGATATGTTTGTATTATTATCCACAGAGTATTCAAATTGTGCTTTGTGATCTAACACAATAGTTTGTGGTTGTGAATCATTCCTGAACACAAAGAAAGGTGTCATTAAAAATTGTGACAAGTGGTTCTTTGGTCACCCTGAAGT
ASV52	GGTACAGGTTGAACTGTATATCCTCCGCGATCACAGATAGCCATTGCCATCTGGATTTCCCAGATTTTGCCGATGAGCTTGACACTATAATAAGCCGAGCGCAGGCCGCGGGCGTTCATCGCATGGTAACGATTTGTACAAAATTACAGAATGAACCCTCTGTACGCGCCATCGCCGCGCGATATGCACCTGTTTTTTACGCGGCTGGCACCCATCCGATGAGCGCAGCAGATGATTTTTTGGTCACCCTGAAGT
ASV53	GGTACAGGATGAACAGTATACCCTCCCCATATACCATTTACGTCTAAAGTAGGTCTAATGCTCATTCTCTCATATGGAGTATAATCGGACTCCCCTTCATGCGCACCTATATCAATACTTGCTTTATGTGTTTCCTCAGAAAAAGGAGCCCTTGCCATAGCCGCTCTTTCATCGGAAGTGAGTTCTAAGACGTCGTCGTAGAATCCATCGACTGTGATTTTTTGGTCACCCTGAAGT
ASV54	GGTACTGGATGAACTGTTTATCCCCCTCCTCTCACTAGTCTCTGTCGTCTTCACCAAGGTCTCCAATGTCCATCCTCCCTCCTGTCCTACTCTGATACTCTGTCCTCCTCTGACACTCTGTCCTCCTCTGATACTCTGTTCTCCTATGATACTCTGACCTCCTCTGATACTCTGTTCTCCTCTGATTTTTTGGTCACCCTGAAGT
ASV55	GGAACTGGTTGAACTGTTTATCCTCCTCACGCTTTGTGGCGTAGGCAAGATGAACAAGTTTATCCTCCTCACCCCTTTCTGCGCCCGGAGTGGAGAATCCCTTGCGAAACCTTGTAGCGCGTGATTGCCTACGTTTGCCTGGACAAGGAGATCCCTGCAACAGGTCAAAGCGCAGCGGGGCGGGAATAGCATGGATTCCATAAAAACACGATTTTGATTCTTTGGTCACCCTGAAGT
ASV56	GGAACTGGTTGAACAGTTTATCCTCCTAATGGTAGGGGGATCCTCCAGGTGGCGAACGACCCACCCACCCTCGGGAGGAGCTCCAGGGTGGGTCGATGGGTTGCACCTATCCCCCTACCCCAAATCGATTTCGTGGAATCCAAAACAATCCACTCCCCCAAATTGTTTCGCGCGAGGGAAGTGCCAATCCAAAATCCCCGCGCGGTTGGAAGCAATTTTGTCAAAATGCAAAAATCCTGAACATCCTGGCGTTTTGGGATTTTCGAAAATACTTAAAATCCCCGGTTGGTTCTTTGGTCACCCTGAAGT
ASV57	GGTACAGGTTGAACTGTTTATCCTCCGGTGTAGGCCTTATGAAAATGCCTTTATTTGTTTGGTCTTGGCTGATTACCGCATATCTTCTTATCGCTGTTATGCCTGTTTTGGCAGGAGCAGTAACAATGATGTTAATGGACATACATTTTGGGACAAGTTTCTTTAATGCAGCTGGCGGCGGCGACCCAGTTCTTTTCCAGCATATATTTTGGTTTTTTGGTCACCCTGAAGT
ASV58	GGTACAGGTTGAACTGTTTATCCTCCTGCCGGACTGGATGCCATTACTCTCTTGGCGGATGTGGCCTCAATCATGCTTCCCCATTTGATCTCAGTTCCCTGATTGCTCTCCTTTTTTGTTTTTTCCTTCTCGTCCAATTTCATCTTGAGTTCGTTCATTTGCTTGTTGTGATTCTTTGGTCACCCTGAAGT
ASV59	GGAACAGGTTGAACAGTTTATCCTCCACGGGGCTATGATCAAAAAAAATAAGTTTCAGTATGAAAAACTTTAAATAAAAAAATTACACTAATAACACCAAGGATTTCCCTTGGCGGTCTTCCAGTACTTAAAGGTTAAATTCATAAATCAAGAATCAGGAATCTAATGACAGTACACTTTATAGGAGCAGGGCCGGGGGCGCCTGATTTGATCACAATTCGTGGACGCGACTTAATCGCAAAATGCGAGGTTTGCCTTTACGCTGATTCTTTGGTCACCCTGAAGT
ASV60	GGTACTGGTTGAACTGTATATCCCCCGCGATCACAGATAGCCATTGCCATCTGGATTTCCCAGATTTTGCCGATGAGCTTGACACTATAATAAGCCGAGCGCAGGCCGCGGGCGTTCATCGCATGGTAACGATTTGTACAAAATTACAGAATGAACCCTCTGTACGCGCCATCGCCGCGCGATATGCACCTGTTTTTTACGCGGCTGGCACCCATCCGATGAGCGCAGCAGATGGTTCTTTGGTCACCCTGAAGT
ASV61	GGTACTGGTTGAACTGTATATCCCCCGCGATCACAGATAGCCATTGCCATCTGGATTTCCCAGATTTTGCCGATGAGCTTGACACTATAATAAGCCGAGCGCAGGCCGCGGGCGTTCATCGCATGGTAACGATTTGTACAAAATTACAGAATGAACCCTCTGTACGCGCCATCGCCGCGCGATATGCACCTGTTTTTTACGCGGCTGGCACCCATCCGATGAGCGCAGCAGATGATTCTTTGGTCACCCTGAAGT
ASV62	GGTACTGGTTGAACTGTTTACCCCCCGGTGTAGGCCTTATGAAAATGCCTTTATTTGTTTGGTCTTGGCTGATTACCGCATATCTTCTTATCGCTGTTATGCCTGTTTTGGCAGGAGCAGTAACAATGATGTTAATGGACATACATTTTGGGACAAGTTTCTTTAATGCAGCTGGCGGCGGCGACCCAGTTCTTTTCCAGCATATATTTTGATTCTTTGGTCACCCTGAAGT
ASV63	GGAACAGGTTGAACTGTTTACCCTCCGAATACTATTTCCTTTGATTGAGTCTTCATCGTTGGGTATCTGATTTAAAGATATGGCACCAAAATTTGACACTCCAGGAGATGCAAATTTTTTCTGTTTTAATACTACATCTAAATCTTTTCTTAACTTTGAAATATCAAATTTAAGTTCCGGTACTTGATAGAAATCTGCAAAATTTATATTACCCATAATTTTTAACTATTTACACATATTATCATCTAAATAACTGTGGTTCTTTGGTCACCCTGAAGT
ASV64	GGAACAGGTTGAACTGTATATCCCCCTTTCTAGAAATATTGCACATGCAATTGGTATTGGCAGGAGCTATTACTATACTATTGACAGATCAAAATTTAAATACAACTTTTTATGATGTAGGTGGAGGTGGAGATCCTATTTTATACCAACATTTATTTTGGTTCTTTGGTCACCCTGAAGT
ASV65	GGAACAGGTTGAACTGTATATCCCCCGGCCGTTTCGATGGGCGTTGATTGCCAGCCAGTAGTGTTGGAAGCCGCGAATAAATCTCGGCCATGTCTGCATTCGCGCTGATCACCGCGGCGCCAGCCTTATTTGGCCGCAAGCCGCCGCCGCCGCCGCCGCCCGAGCCCGAGCCCGAAGTTCTCGCAACACTCGTCGCGGTGACTGTGTGCTGGCTACTGCCGATGGTTCTTTGGTCACCCTGAAGT
ASV66	GGTACTGGTTGAACTGTTTACCCCCCGGTGTAGGCCTTATGAAAATGCCTTTATTTGTTTGGTCTTGGCTGATTACCGCATATCTTCTTATCGCTGTTATGCCTGTTTTGGCAGGAGCAGTAACAATGATGTTAATGGACATACATTTTGGGACAAGTTTCTTTAATGCAGCTGGCGGCGGCGACCCAGTTCTTTTCCAGCATATATTTTGGTTCTTTGGTCACCCTGAAGT
ASV67	GGAACTGGTTGAACAGTTTACCCCCCGGTGTAGGCCTTATGAAAATGCCTTTATTTGTTTGGTCTTGGCTGATTACCGCATATCTTCTTATCGCTGTTATGCCTGTTTTGGCAGGAGCAGTAACAATGATGTTAATGGACATACATTTTGGGACAAGTTTCTTTAATGCAGCTGGCGGCGGCGACCCAGTTCTTTTCCAGCATATATTTTGATTCTTTGGTCACCCTGAAGT
ASV68	GGTACTGGATGAACTGTTTATCCCCCGCGATCACTGATAGCCATTGCCATCTGGATTTCCCAGATTTTGCCGATGAGCTTGACACTATAATAAGCCGAGCGCAGGCCGCGGGCGTTCATCGCATGGTAACGATTTGTACAAAATTACAGAATGAACCCTCTGTACGCGCCATCGCCGCGCGATATGCACCTGTTTTTTACGCGGCTGGCACCCATCCGATGAGCGCAGCAGATGGTTCTTTGGTCACCCTGAAGT
ASV69	GGTACTGGTTGAACTGTATATCCCCTGCGATCACTGATAGCCATTGCCATCTGGATTTCCCAGATTTTGCCGATGAGCTTGACACTATAATAAGCCGAGCGCAGGCCGCGGGCGTTCATCGCATGGTAACGATTTGTACAAAATTACAGAATGAACCCTCTGTACGCGCCATCGCCGCGCGATATGCACCTGTTTTTTACGCGGCTGGCACCCATCCGATGAGCGCAGCAGATGGTTCTTTGGTCACCCTGAAGT
ASV70	GGTACTGGTTGAACAGTTTACCCTCCTAACTATACGCCTATTTAAGACTTGCTTTCGCTTCGGCTACAGACCTTAAGTCCTTAACCTTGCTAGAGAGGAGTAACTCGTAGGATCATTATGCAAAAGGCACGCCGTCGCCCGAAGGCTTCGACCGCTTGTAGACAGCTGGTTTCAGGTACTATTTCACTCCCTTGTTCAGGGTACTTTTCACCTTTCCCTCACGGTACTTGTTCGCTATCGGTCTCTCAATATATTTAGCCTTACCAGATGATTTTTTGGTCACCCTGAAGT
ASV71	GGTACTGGTTGAACTGTATACCCCCCGGTGTAGGCCTTATGAAAATGCCTTTATTTGTTTGGTCTTGGCTGATTACCGCATATCTTCTTATCGCTGTTATGCCTGTTTTGGCAGGAGCAGTAACAATGATGTTAATGGACATACATTTTGGGACAAGTTTCTTTAATGCAGCTGGCGGCGGCGACCCAGTTCTTTTCCAGCATATATTTTGATTCTTTGGTCACCCTGAAGT
ASV72	GGAACTGGATGAACAGTATATCCCCCGAATAAAAAACCCAATCCTTTTTTAATAACCGATTGACTTTTGTACCCCACGTGGTAGGATGAAAACGATTTATTCTAGCGAATAGATCATTTAGGTTACCTAAAACAAACAAACAAACAAACAAGACTACTATGAAAAACAAAATACTAGCTATGCTAGTTGCTTTCGGTCTGGTGGGATCCGTTTCCGCTATCGAAATCAACGAAAACCTCTCCATCAATGGTTTCATCGATGATTCTTTGGTCACCCTGAAGT
ASV73	GGTACTGGTTGAACAGTTTACCCTCCTCATTCGTCAGCCTCGAGTTCCCGGAGACGCTGCCGGCGCCGTTCGTTGGCGAGGACGGCGTTGCTTACCTGAAGTTCGCACCGAGTTGTGGTCACGTCAAGTCCGGAGGCACTAAGGCGATCACAGCCACGTTCGAAGCGCCAGTGAAGGTAGGATAAACAGTCGCGCAGAGGAACATCTGAGATTTCATGGTCGGTGATTTTTTGGTCACCCTGAAGT
ASV74	GGTACTGGATGAACTGTTTATCCCCCATCACCAACAGCTTCAACGCGAGCTTTGTTTATAGGCTTTGCTATAAATACTACAGACATTGTATTTAGACCGGGAATACCTATATCAGGAACTTAATATGACTATTGCAAATATAACTAAAATAATTTCCCTCGCGGAAGATTCTGATTCTTTGGTCACCCTGAAGT
ASV75	GGTACAGGTTGAACTGTTTATCCCCCGGCCTTCATTGAGCTTTGGGGCTCAAGAGAAGATCGCCTGAACAGCTTGGAACAGGCGATTCAATGCGAAAAGAACAAACGGATCTAAAAGTCCTAGGCTGAACAACAGATATCTCACTCCCGATGCGATTGCGCTTATTGGCTGCGCTGATGGTTCTTTGGTCACCCTGAAGT
ASV76	GGAACTGGTTGAACAGTTTACCCTCCTTTGGCCAAAAGGCCAGGCCCCTAGCCCCTGGAAGGATGCCTTGCGTGTAAACTAATGGAAGCCTTATTTAGTGAAGGAACTTGTCTTTTTATTGCTTTTTCAGTTTCTAGTGTTTCTAGTGTCACCGTGTTTCTATATTGATTCTTTGGTCACCCTGAAGT
ASV77	GGTACAGGATGAACTGTATATCCTCCCCATATACCATTTACGTCTAAAGTAGGTCTAATGCTCATTCTCTCATATGGAGTATAATCGGACTCCCCTTCATGCGCACCTATATCAATACTTGCTTTATGTGTTTCCTCAGAAAAAGGAGCCCTTGCCATAGCCGCTCTTTCATCGGAAGTGAGTTCTAAGACGTCGTCGTAGAATCCATCGACTGTGATTCTTTGGTCACCCTGAAGT
ASV78	GGAACAGGTTGAACAGTTTATCCCCCTCTTTCAAGAAATATTGCCCATGCTGGTGGCTCTGTGGACTTTGCCATTTTTTCTTTACACCTCGCAGGGGTAAGATCTATTTTAGGTGCTGTTAATTTTATTAGTACTCTAGGTAATCTGCGAGTATTTGGTATATTGCTAGACCAGATACCATTGTTTGCTTGATCCGTACTAGTTACAGCTATTCTTTTACTCCTTTCTTTACCAGTTTTAGCTGGAGCTAATATCAACATCTTTTTTGGTTCTTTGGTCACCCTGAAGT
ASV79	GGTACTGGTTGAACTGTTTACCCCCCTTTAAGTAGTGCACAGGCTCATTCTGGGCCTGCCGTAGACCTTGCTATTTTCAGTTTACACTTATCAGGAGCCTCTTCTATTTTGGGAGCTATAAATTTCATCACAACCATTTTTAATATGAGAGCGCCTGGAATGTCTATGCACCGACTACCTTTGGTTCTTTGGTCACCCTGAAGT
ASV80	GGAACTGGATGAACAGTTTACCCTCCCAGGATAGAGGCTGGTCAGTTGAAACACATGCAGGTGTTTCGATATCCAAGTAGCAGCGAGCCACGGTAATATTCGATTGGACTTCCTATATTATTAATTGATGTCCCCGGATTGACATGATCCTGATATGAAGCAAATATGCCAAAACAACAGTCTTTGCTACCTTTGGTTTCGTGATTGGCTCTTTGGTAGCCTTCTTTTGTTTTTTTTGTCTGACTTTGCTTTCTGGCTTGGTCGCTTTGGTTTTTTGGTCACCCTGAAGT
ASV81	GGTACTGGATGAACTGTTTATCCCCCAGGCTTGATGTTCTGGTTGAATAGATTTTGGCAGTGCCGCCGAAACTGGCTGCGGCGTGGACTGAGTTCCTGTGGTGCAAGCCGTAAGAGCCAGAGCAAAGACGGCTGCAAGCAAACGCATAGCGGTTTCTTGGTTAGGGTTTGAGGGAATACCGAAAGGTGCAGCAGGAGGCCCCCTTCATGATTCTTTGGTCACCCTGAAGT
ASV82	GGAACAGGTTGAACAGTTTATCCCCCTCTTTCAAGAAATATTGCCCATGCTGGTGGCTCTGTGGACTTTGCCATTTTTTCTTTACACCTCGCAGGGGTAAGATCTATTTTAGGTGCTGTTAATTTTATTAGTACTCTAGGTAATCTGCGAGTATTTGGTATATTGCTAGACCAGATACCATTGTTTGCTTGATCCGTACTAGTTACAGCTATTCTTTTACTCCTTTCTTTACCAGTTTTAGCTGGAGCTAATATCAACATCTTTTTTGATTCTTTGGTCACCCTGAAGT
ASV83	GGTACTGGTTGAACAGTTTACCCCCCACGGGGCTATGATCAAAAAAAATAACTTTCAGTATGAAAAACTTTAAATAAAAAAATTACACTAATAACACCAAGGATTTCCCTTGGCGGTCTTCCAGTACTTAAAGGTTAAATTCATAAATCAAGAATCAGGAATCTAATGACAGTACACTTTATAGGAGCAGGGCCGGGGGCGCCTGATTTGATCACAATTCGTGGACGCGACTTAATCGCAAAATGCGAGGTTTGCCTTTACGCTGGTTCTTTGGTCACCCTGAAGT
ASV84	GGTACTGGTTGAACAGTTTACCCCCCTCCTGCCAAAGTCAAGCCAGGCCAGAAAAATGAACCAGAGGAGGTTGCCCCTTACAGACTGGACATCCGGATAGGCAAGATTGTCGAGGTGTCCAGACATCCAGATGCCGAGAAGCTCTATGTGGAGAAAATTGATTTGGGTGAGCCGAATCCTAGAACTATCGTTTCGGGATTGGTGGATTTTGTGCCCGAGGACAAAATGCTCAACAGGCTTGTTGTGGTTCTTTGGTCACCCTGAAGT
ASV85	GGTACAGGTTGAACAGTTTATCCTCCAAGGAAGGATTTCTTCAGGGTCTACGCAAACTTTGCGATGATTACGGCGGTTTGCTTATCTTCGATGAGGTGATGACAGGCTTTCGTGTTGCGCTAGGTGGCGCACAGGCCTGCTACGGAGTTAAGCCTGACCTTACAACCTTAGGCAAAGTGATTGGCGGCGGTTTGCCTGTTGCTGATTCTTTGGTCACCCTGAAGT
ASV86	GGTACAGGTTGAACTGTTTACCCTCCTTCCATCCACATCTCTTTGTTTCTGTCCGTTTGTATCTCTTTCTGTTTTTTTTCTGTCTGTTTCTGTCAGTTTCTATCTTTTTCTGTTTCTGCTAAACTGTACTAAACTTGGCTAGACTTGGCTAACCTTCACTGAACTTTCTGTATTTTTCTGTTTCTGTCCTTTTTGTTAGTTTGTGTCCGTTTCTGTCTGATTCTTTGGTCACCCTGAAGT
ASV87	GGTACTGGATGAACAGTTTACCCTCCCCTTCCAGATATTAAAACCGGGGCGCACGCCCCCCCGACACCTCAGCGCCCTCTCGGGCAGCCGTCTTCAGTGCTCCCCTTCTCGCCCGGCGAAGACGGTCAGCACCGCCAATATCATCCTCTTCCTCGATGATATCCCTCAGGTACGTGGTTCTTTGGTCACCCTGAAGT
ASV88	GGTACAGGTTGAACTGTTTATCCTCCCACCTTCAGGAGTTGTCCAGTTAATGTTTTGTGAAGGGTCTTTAATATCACATGTTTTGCAATGTAAACAATTTTGAGCATTGATTTGAAGTATTTTTTCATTATTTTTATCATTGATAATCTCATAAACTCCTGCAGGACAATAAAATTGTTCTGGTGCACCATAAATAGGTAAATTATGCTTAATGGGAATATTATTATCTAATAATTCCAGGTGGATGGGTTGGTTCTTTGGTCACCCTGAAGT
ASV89	GGTACTGGATGAACAGTTTACCCTCCATCCTCTCCTTCTTCGCACGTTTACACCCAATTGGTCTCTCCAACTTCATTGACGAATAAACCCCAACATTAACACCCGACAATGAAATATCATCCGAACTGACTATATCCGTTTCCATACTGTCTCCATTATCAGCACAAAACTTGGGCATTTGTTTTAAGACAGCTACACATTCAAGAAAACGAAAATACTTACCGGTCCGGTCTAAAAACATCGCCATCACCTCCTTCTCCACATCTTCTTCCGAAACACCGCTTTGATTTTTTGGTCACCCTGAAGT
ASV90	GGAACTGGATGAACAGTTTACCCCCCTTCAAACACGACTGATTCAGTTTGCACTTTCACGGCCTTCGCCAAAATGTCGATACCCTCAGCCTGGATAAGCTCGAAGGTTCCATCTACGTTTAGGAGAAGTTGTTTTGTGGTTCCAGGGTGAGTCAGAGTAATCTGACCATCCAAAATGACTAGCTTGTCGATAGTCAGAGGAGTTTCTTTTATTTTATTTGTTGTGGATTCAAGAGTTTCAGGCCTAACGAGTTCTTGATGATCTGCAGATTTTTCTTTTTCAGTTTGTTCATTTTTAGCCTGGTTCTTTGGTCACCCTGAAGT
ASV91	GGAACAGGTTGAACAGTTTACCCCCCATTTTTTGTCTAGTTTGTTTTCGTGCGTCGATAAAAACATGTTTTTTTAAGTCAAAGGCACTCTGAAAAAAATCAAGACTTACTCTATGATTAGGCTTTCTTAGTACCATCTACCCTCCTTTGGGAATATTTGGGATATAATGGGATATCAACCTGTGATTGTCAATAGGTTATTTTGAGCAAAAAAGGCTAATTTCACGAAAAATCGTATGGATTGGTTCTTTGGTCACCCTGAAGT
ASV92	GGTACAGGATGAACAGTTTATCCCCCTTCCTATTTGCTGGCCTACCGTCTGGATACGCGCCTGCTTACTACAGTACAACATTTTCAAGTAAAATCATATTTGATGTTTTCTTAACCATATTAGGCCGTCCCTGTTTTTTGTTTTTTTAAGATCAGTTTTTTTCTTCATTTTTCTCTATTGCTTTGATTCTTTGGTCACCCTGAAGT
ASV93	GGTACTGGTTGAACTGTTTATCCCCCCTGTTAAGTTTGGTTTTATTAGACTTGTGAGATTTTCACCTAGAAGATCTGTTTTCATGCTTTTATGCTTTTATTCTTTTAAGCATTCTTTTTGCCTCTGTTAATTGATTGTTCAAAGACTTAATAGCCTCTTCCACTTGTTCTTTTTTTGTTGTGTCTTTTATCGTGGTTCTTTGGTCACCCTGAAGT
ASV94	GGTACAGGTTGAACTGTTTATCCTCCTCCTCTCGCTAGTCTCTGTCGTCTTCACCAAGGTCTCCCTTGTCTATCCTCCCTCCTGTCCTACTCTGATATCCTGTCCTACTCTGATATTCTGTCCTGCTCTGATACTCTGTCCTACTCTGATATTCTGTCCACCTCTGATTCTTTGGTCACCCTGAAGT
ASV95	GGAACAGGTTGAACAGTTTACCCTCCGCTTGTGAGTGGCTGGCCTATTCACTGTGCTGGTTGCTGGCAGGTGGCGTTTCATGACTGGGCATACTACCTCAGAGGACTTCCGCACTGAAGGAGGCTGGTTGACAGATACAAGAAAAAGGGTGTGGGGTCAGGCATTTGGATCAATTGTGTTTCTAGTGATGTTCGTGATTTTCAAGTGGTTTTTTGGTCACCCTGAAGT
ASV96	GGAACTGGTTGAACTGTTTACCCTCCGCGATCACTGATAGCCATTGCCATCTGGATTTCCCAGATTTTGTCGATGAGCTTGACAATATAATAAGCCGAGCGCAGGCCGCGGGTGTTCATCGCATGGTAACGATTTGCACAAAATTACAGAATGAACCTTCTGTACGCGCCATCGCCGTGCGATATGCACCTGTTTTTTACGCGGCTGGGACCCATCCGATGAGCGCAGCAGATGATTCTTTGGTCACCCTGAAGT
ASV97	GGTACTGGATGAACTGTTTATCCTCCAACTCTTGCGCAACAAGGCAAAGTGGCAAATAGCCCGCACCAACGCCGCCAAAGGCTTCCGGGATCGCGGTGCCTTGCAGCCCAAGCTCCGCCAAACCCTGCCAGACATCGCTGGCCTGCAGGGATTCCCCTTCCATGATCGATCGATGTCGGCTCAAGGGGCTCTTCTCGCTCAAAAATCTGCGAACCTGTTCTTGGATCATTCGATCCTCGCTAGAAAAATCAAAATTCATCGGTGTTTTTATTCCTCGTCAATTGTTTTACTGGTTTTTTGGTCACCCTGAAGT
ASV98	GGTACTGGATGAACAGTTTACCCTCCGCGATCACAGATAGCCATTGCCATCTGGATTTCCCAGATTTTGCCGATGAGCTTGACACTATAATAAGCCGAGCGCAGGCCGCGGGCGTTCATCGCATGGTAACGATTTGTACAAAATTACAGAATGAACCCTCTGTACGCGCCATCGCCGCGCGATATGCACCTGTTTTTTACGCGGCTGGCACCCATCCGATGAGCGCAGCAGATGGTTTTTTGGTCACCCTGAAGT
ASV99	GGTACTGGTTGAACAGTTTATCCCCCGTGAAATGTAATGTCAGTCAATGAGATTTATCAAAATTCCTAGAATAAAAGCATCATGTCATACTGGTCCTTCTTTATCCTGTCTAGTAAAAAATTTCATTTTAAGCATCCATAGTCTTTTTTTTTTGGCTTCAATTCTTTCATAGTACTCATATGGTTTTTTGGTCACCCTGAAGT
ASV100	GGTACTGGTTGAACTGTATACCCCCCGGTGTAGGCCTTATGAAAATGCCTTTATTTGTTTGGTCTTGGCTGATTACCGCATATCTTCTTATCGCTGTTATGCCTGTTTTGGCAGGAGCAGTAACAATGATGTTAATGGACATACATTTTGGGACAAGTTTCTTTAATGCAGCTGGCGGCGGCGACCCAGTTCTTTTCCAGCATATATTTTGGTTCTTTGGTCACCCTGAAGT
ASV101	GGTACAGGATGAACTGTATATCCCCCAGATGATGGTTCAGTCAAACCTTATCGGTTGCACTGCACTGCGCACACCGCACGAAATTGAATTGATTTGTACTGCACTAAACTGCACTTAAATGTACTGCAATCAACTGCCATTAACTGTACTACACTACAATTTATTATACTGAACTGATTTGCACTGTACTACAGCTTCCTATGTTTTCACTACCCAGTTCAGTTGCTTTATACTGTATTGCACTACCCTGGTTCTTTGGTCACCCTGAAGT
ASV102	GGTACTGGTTGAACTGTATACCCCCCTATGCTATATATGGGCTATGTTGGCTTGGCAGTACCTTTTGCTTTTGTGGTATCTGCATTAATAAGAGGACAGCTTGATAGCACATGGCTAAGATGGACTAGGCCTTGGGCACTAATCTCATGGGCCTTTTTAACAGTTGGAATTACTCTTGGAAGTTGGTGGGCGTATTATGAACTTGGTTGGGGTGGATGGTGATTCTTTGGTCACCCTGAAGT
ASV103	GGTACTGGTTGAACAGTTTACCCCCCAACTCACAAATATAAAAACCGGACTTTTTCACATTTTACCAACCAAAAAAAACCCTGAACAATTTGGGTAACTTAACCTATCAAAAAATACCCCAAAAATCAAAATATCATAAAAAACAAAGATACCCTGAGAAAGTAAAAGCTATTGTGATTCTTTGGTCACCCTGAAGT
ASV104	GGAACTGGTTGAACAGTATATCCCCCGCCAGGCGGAGCTTCTCCGCGGTGATCGGCTGGTCACGAGCGGCGCCGACGGGATCTACCCGCCCGGGCTCCCGGTGGGCCGGGTGACCGCCGTCAGAGAGAGTGCGCACGCGTTTCTCGAGGTCCGCGCCGAACCGGCCGGAACCATCGCCACCGCCCGGGTGGTGCTGCTGCTCGATTCCTGGTCCGGCCCCCATCCGACAGGAGACCGCAGCCCATGAAGACGGTGGTTCTTTGGTCACCCTGAAGT
ASV105	GGAACAGGTTGAACAGTATATCCTCCGCGATCACTGATAGCCATTGCCATCTGGATTTCCCAGATTTTGCCGATGAGCTTGACACTATAATAAGCCGAGCGCAGGCCGCGGGCGTTCATCGCATGGTAACGATTTGTACAAAATTACAGAATGAACCCTCTGTACGCGCCATCGCCGCGCGATATGCACCTGTTTTTTACGCGGCTGGCACCCATCCGATGAGCGCAGCAGATGATTCTTTGGTCACCCTGAAGT
ASV106	GGTACAGGTTGAACTGTTTACCCCCCTTTAAGTAGTGCACAGGCTCATTCTGGGCCTGCCGTAGACCTTGCTATTTTCAGTTTACACTTATCAGGAGCCTCTTCTATTTTGGGAGCTATAAATTTCATCACAACCATTTTTAATATGAGAGCGCCTGGAATGTCTATGCACCGACTACCTTTGGTTCTTTGGTCACCCTGAAGT
ASV107	GGTACTGGTTGAACTGTTTATCCTCCGCGATCACTGATAGCCATTGCCATCTGGATTTCCCAGATTTTGCCGATGAGCTTGACACTATAATAAGCCGAGCGCAGGCCGCGGGCGTTCATCGCATGGTAACGATTTGTACAAAATTACAGAATGAACCCTCTGTACGCGCCATCGCCGCGCGATATGCACCTGTTTTTTACGCGGCTGGCACCCATCCGATGAGCGCAGCAGATGGTTTTTTGGTCACCCTGAAGT
ASV108	GGAACAGGTTGAACTGTTTACCCCCCAAATATTATTAGATCGTCTGTGTATCTGTATTCCCAATTTTCTTTTGGTAGATCTACATATCCTCCATTATCTATTACGTATGTTGGAAATGATACTTTAGCACTTCTGAATGATTTTGTTTTTAATGATTTGTTAATGAAATTAATTACTATGCTTCCAACATTTCCCATATCTTGCATTGCTGCAATGATGATTGGTTTTTTGGTCACCCTGAAGT
ASV109	GGAACTGGATGAACTGTATATCCCCCGTTTAATCGATGAGGAAACAGTGGGAATCTCGATCGATGAAACAACCACGGCAGCAGATATTGCAACACTTTGGGATATCTTGATCGGGCCACATGATTTAGATGTGGATGTGATAGCTCAAAATATTGGAGAAAACCTACCGAGCGGTCTAATAAGAACGACTGATTCTTTGGTCACCCTGAAGT
ASV110	GGAACAGGTTGAACTGTATATCCTCCTTTAAGTAGTGCACAGGCTCATTCTGGGCCTGCCGTAGACCTTGCTATTTTCAGTTTACACTTATCAGGAGCCTCTTCTATTTTGGGAGCTATAAATTTCATCACAACCATTTTTAATATGAGAGCGCCTGGAATGTCTATGCACCGACTACCTTTGGTTCTTTGGTCACCCTGAAGT
ASV111	GGAACAGGTTGAACAGTATACCCTCCCAGAGCCTAATGCGCCTCAACATGAGTCAGCAGGGAATGGTGTGCCGAGGAGGGGCTGGCAGAAGGCAGTAGGGCCAGACACATGTGTGGTCATGCTTGCTCAGCCCCCATAGGTGAGCTGTCTTGGCCTTCCAAACCTCCCTGCCCCTCTCAGCTGATTCTTTGGTCACCCTGAAGT
ASV112	GGTACTGGTTGAACAGTATATCCTCCGTGAAATGTAATGTCAGTCAATGAGATTTATCAAAATTCCTAGAATAAAAGCATCATGTCATACTGGTCCTTCTTTATCTTGTCTAGTAAAAAATTTCATTTTAAGCATCCATAGTCTTTTTTTTTGGCTTCAATTCTTTCATAGTACTCATATGGTTTTTTGGTCACCCTGAAGT
ASV113	GGTACAGGATGAACAGTATACCCTCCTTAGTAATTTTCTTGAGTGGGGTTCAGCACGGTTTCTTTGTCCCCCCTAAATGGTTCCCGTATCCACCAGATTATTCAGAATCCTGCCCCCCCAAATGGTTTTCCCTCCCTAGATGCCTTCCCGCCCACAATTTGTGTTGTGTTCCACCCCTATTGGTTCTTTGGTCACCCTGAAGT
ASV114	GGTACTGGTTGAACTGTTTACCCCCCGAATAAAAAACCCAATCCTTTTTTAATAACCGATTGACTTTTGTACCCCACGTGGTAGGATGAAAACGATTTATTCTAGCGAATAGATCATTTAGGTTACCTAAAACAAACAAACAAACAAACAAGACTACTATGAGAAACAAAATACTAGCTATGCTAGTTGCTTTCGGTCTGGTGGGATCCGTTTCCGCTATCGAAATCAACGAAAACCTCTCCATCAATGGTTTCATCGATGATTTTTTGGTCACCCTGAAGT
ASV115	GGTACAGGTTGAACTGTTTATCCCCCAAAAAACAGACACGCACAGACGTTTCCAGACACGCAATCGAATCCTTGAACCGGTGCGCATCTTTTATAAAAAATATATTCGCCGGGCCTTCGGCCCATCGGCGTGTGTGATCATCTACTGGTTGTTGGTCTTTTAATCCCTAGACGCGAGTGCCGTGACCCCCCTGGCGACCGGTCCGTCCATTCGTTGTTACTCGGGGGGCTTTTTTCGAGCCTTTGGCGCTCCACGGGTCGATTTTCCTGATTTTTTGGTCACCCTGAAGT
ASV116	GGAACTGGATGAACTGTTTATCCCCCTCTGTAATTTGGATCCCCTCTTTCCGACGAGGTGCATCCTGAGTGCCGTACGGAAGGCCAGAATATGCCAAGCTGCATATGTTTCACGATATGTTTCACGATGTGTTTGTGCGTTAGTCCAGACTGAGACGGGGACACGGCACCAAAAATGAAACATTGTGTCATTCTGTGGTGTTGGTTGGTTGGTTGGTTGGTTGGTTGATTTTTTGGTCACCCTGAAGT
ASV117	GGTACTGGATGAACTGTATATCCCCCGTTTAATCGATGAGGAAACAGTGGGAATCTCGATCGATGAAACAACCACGGCAGCAGATATTGCAACACTTTGGGATATCTTGATCGGGCCACATGATTTAGATGTGGATGTGATAGCTCAAAATATTGGAGAAAACCTACCGAGCGGTCTAATAAGAACGACTGGTTCTTTGGTCACCCTGAAGT
ASV118	GGAACTGGTTGAACAGTTTACCCTCCGACAATATGTTTTTCACTATTTTTCATCTTCTTATCCATTTATGTGGAGTTTCAGCTTTTAAACGTGCTTTTACTCGTTATTTGACCCTTACATTAAGCCATTTTTTGATGTTTTTCATCAAATTGTGGTTCTTTGGTCACCCTGAAGT
ASV119	GGTACTGGTTGAACTGTTTACCCCCCGGTGTAGGCCTTATGAAAATGCCTTTATTTGTTTGGTCTTGGCTGATTACCGCATATCTTCTTATCGCTGTTATGCCTGTTTTGGCAGGAGCAGTAACAATGATGTTAATGGACATACATTTTGGGACAAGTTTCTTTAATGCAGCTGGCGGCGGCGACCCAGTTCTTTTCCAGCATATATTTTGGTTTTTTGGTCACCCTGAAGT
ASV120	GGAACTGGATGAACAGTATACCCCCCGCGATCACTGATAGCCATTGCCATCTGGATTTCCCAGATTTTGCCGATGAGCTTGACACTATAATAAGCCGAGCGCAGGCCGCGGGCGTTCATCGCATGGTAACGATTTGTACAAAATTACAGAATGAACCCTCTGTACGCGCCATCGCCGCGCGATATGCACCTGTTTTTTACGCGGCTGGCACCCATCCGATGAGCGCAGCAGATGGTTCTTTGGTCACCCTGAAGT
ASV121	GGTACAGGATGAACAGTATACCCTCCCATATACCATTTACGTCTAAAGTAGGTCTAATGCTCATTCTCTCATATGGAGTATAATCGGACTCCCCTTCATGCGCACCTATATCAATACTTGCTTTATGTGTTTCCTCAGAAAAAGGAGCCCTTGCCATAGCCGCTCTTTCATCGGAAGTGAGTTCTAAGACGTCGTCGTAGAATCCATCGACTGTGGTTTTTTGGTCACCCTGAAGT
ASV122	GGTACAGGATGAACTATATATCCCCCAAACTCACAAATATAAAAACCAGACTTTTTCGCATTTTACAAAAAACTAAAATTGGAAAAATTGGGGTAACTTAACTTATTAATAAATACCCCAAAAATCAAAATATCATTAAAAACAAAAATACCCTGAGAAAGTAAAAGCTATTGTGATTTTTTGGTCACCCTGAAGT
ASV123	GGTACAGGATGAACAGTTTACCCTCCTGTAATCTAAAGTCATATTTTTTTCTACACCCCCCTAATCAGATGATTAGGAATTGTTCTCTCTAATGTCATGTTCAACGGTTGAAGATAAATAAAAACTTTCTAAATTTCGCCAGTAATTTCATAATGTTAATTGGTTCTTTGGTCACCCTGAAGT
ASV124	GGAACAGGTTGAACTGTTTACCCCCCGCGATCACTGATAGCCATTGCCATCTGGATTTCCCAGATTTTGTCGATGAGCTTGACAATATAATAAGCCGAGCGCAGGCCGCGGGTGTTCATCGCATGGTAACGATTTGCACAAAATTACAGAATGAACCTTCTGTACGCGCCATCGCCGTGCGATATGCACCTGTTTTTTACGCGGCTGGGACCCATCCGATGAGCGCAGCAGATGGTTCTTTGGTCACCCTGAAGT
ASV125	GGAACAGGTTGAACAGTTTACCCTCCGTCAATTCTTAATCCAGTGTCTAAGATGCTTCCCCTAACAATATCTTTTTCAACATTCTTAAATACACTTTTAATATCGGATTCTGAAACATCTAAATCCTCATTATCTGAAAACTCTGACAACAGCTCATTCTTTATATCCGATATTTTATTAGATCTAGCCTGTTTGTCGCTTTCTTTATAAGCGTCGATCAATTTATCTTTTACTGAGTCATTTACTGTTTTTTGGAGATCAGATAGATCAACCTCTATTAACTCTCTTGATTTTTTGGTCACCCTGAAGT
ASV126	GGTACAGGTTGAACAGTATACCCCCCATATACCATTTACGTCTAAAGTAGGTCTAATGCTCATTCTCTCATATGGAGTATAATCGGACTCCCCTTCATGCGCACCTATATCAATACTTGCTTTATGTGTTTCCTCAGAAAAAGGAGCCCTTGCCATAGCCGCTCTTTCATCGGAAGTGAGTTCTAAGACGTCGTCGTAGAATCCATCGACTGTGGTTCTTTGGTCACCCTGAAGT
ASV127	GGTACTGGATGAACTGTATATCCCCCACATTGTGAATCTGAATTTATGTTAGTAAATAGCTGTAATAAGTTTTAAATAAATTCTCCCCCCCTCTTCAATAAAGCTAAGATAGCAACATCACAAAAAATTCCTAGGGGGAGAGTGGCATATATCCTGGATACTGGAGTGGTTCTTTGGTCACCCTGAAGT
ASV128	GGTACTGGATGAACAGTTTATCCCCCCCTGCATTTTTGGAATCCTTTGAGGAACTTTTTTTTAAACCATATTTTAGACGAACTAAAGTTCCTCAAAACGTTTGGATTTTGGTTATCCTCCCCCATTTTTCATGGAAAACATCCAAACCAATGGAAAAAAAGTTCCTCAAAATGTTTGGTTCTTTGGTCACCCTGAAGT
ASV129	GGAACAGGATGAACAGTTTACCCTCCGCGATCACTGATAGCCATTGCCATCTGGATTTCCCAGATTTTGCCGATGAGCTTGACACTATAATAAGCCGAGCGCAGGCCGCGGGCGTTCATCGCATGGTAACGATTTGTACAAAATTACAGAATGAACCCTCTGTACGCGCCATCGCCGCGCGATATGCACCTGTTTTTTACGCGGCTGGCACCCATCCGATGAGCGCAGCAGATGGTTCTTTGGTCACCCTGAAGT
ASV130	GGTACTGGATGAACAGTTTACCCCCCCATATACCATTTACGTCTAAAGTAGGTCTAATGCTCATTCTCTCATATGGAGTATAATCGGACTCCCCTTCATGCGCACCTATATCAATACTTGCTTTATGTGTTTCCTCAGAAAAAGGAGCCCTTGCCATAGCCGCTCTTTCATCGGAAGTGAGTTCTAAGACGTCGTCGTAGAATCCATCGACTGTGGTTCTTTGGTCACCCTGAAGT
ASV131	GGTACTGGTTGAACAGTATACCCTCCTCCACCACCAGGCTGTCCTGCATATCCTCCTCATCCCTCCTCTTCCCCTCGATCTCCTCCTCCTCATTATCATCCTCCTTCTTCTCCTCCTCATTAGGGTGGTGTGAAATTAAACTTTTGTTAAAAAGTCAAAATCCCCAGGCAGTTTCTGGTTTTTTGGTCACCCTGAAGT
ASV132	GGTACTGGTTGAACTGTTTACCCTCCATCAATTGCTTGTTTTCTTCCTTTTTCATTTACAATCAATAATTTTTTCTTTCTATCTGCTTCTATTATTCTTGCATCAACTCCCGATAGTCCTATCGCATTAATTCCGTTTTTTTGTAACATTTGAACAATTGTTTTGTTTATTCTACCTGACATCACCATTGTAAAAATTTCGGCAGTTTCTTTGTCTGTATATCTGCTCTTAATTCCACTTGGGGATGTTACAAACTTTGATTTTTTGGTCACCCTGAAGT
ASV133	GGAACTGGTTGAACAGTTTACCCCCCGAACTCATCCAGTTTCTCCAGTGGGGGCGGACTGGCGTAGGAATCGGCAAGGCCCTCCTCGAACGGATTTTTCACGTCGTCATGGCACTTGATGCACCCTAATCTTAGAAACTCTTTGGCACCTTTTTCAACCCTGACAGGATCCACTTGATAATCGACGTACGTTTCGATCGGCGTATTATAAATCGACAATAATCGGGCGGGGATGGCGGCCCGTTGCCGAGATCCTGATTCCATTTTCAAATCGAAACTTGGTTTTTTGGTCACCCTGAAGT
ASV134	GGTACTGGTTGAACTGTTTACCCTCCCATTATCTAGTAATATACAAAAATCTTCTAAAGCCAAACTACGTCAAACCTGGTTTCACAGAAAGATCTACATCACACAAGTTGCACTGAATTTGACCAACACTTCCAGTTTTGATAGAAATGACTAAAGTTTATTATCTTGCATGGTTCTTTGGTCACCCTGAAGT
ASV135	GGAACTGGTTGAACAGTTTACCCCCCGGTGTAGGCCTTATGAAAATGCCTTTATTTGTTTGGTCTTGGCTGATTACCGCATATCTTCTTATCGCTGTTATGCCTGTTTTGGCAGGAGCAGTAACAATGATGTTAATGGACATACATTTTGGGACAAGTTTCTTTAATGCAGCTGGCGGCGGCGACCCAGTTCTTTTCCAGCATATATTTTGGTTCTTTGGTCACCCTGAAGT
ASV136	GGTACTGGTTGAACTGTTTACCCTCCGCCTCAGCTGGTCGAAAACCCAACCTCTTCGACCCCCACCCTGGAACCTTCGATTCTTGTTCCTCGAGGATATCCTTGCATACTTCTCCACTCAAGGGTCTAGGAACAATCCTGGACAAATCTACAAAAGGTCCAAAGAAATACCGGAAGAATTCCGAGGGAAATCTGGGAAGACTCTCCGAAGAACCCCAGCCAAATCCAGAACAATTCAAGAATTTGCTGACGACCGACGATTGAACGACCAGACGCCTGGACGAATTGATTCTTTGGTCACCCTGAAGT
ASV137	GGTACTGGTTGAACTGTATACCCCCCGGTGTAGGCCTTATGAAAATGCCTTTATTTGTTTGGTCTTGGCTGATTACCGCATATCTTCTTATCGCTGTTATGCCTGTTTTGGCAGGAGCAGTAACAATGATGTTAATGGACATACATTTTGGGACAAGTTTCTTTAATGCAGCTGGCGGCGGCGACCCAGTTCTTTTCCAGCATATATTTTGGTTTTTTGGTCACCCTGAAGT
ASV138	GGTACTGGTTGAACTGTTTATCCTCCTCCTAATTGGAGTCCTTTTTCTACTCCAGGCTTAGTTTGCCAGTCCATATATGATTGTCCTAATTTGCTCCAATCTGCACTTTTAGAGTTGTAATTTCCAACAACTAAAACAAAATTGGTGTCCCAGTTAACATCTGGTTTTGAAACAAAATTATTGTCAAAATCTACATTTCTGATTTCATCGCTATGATTGCCAAGAAAAGAAGCATATTTTTGACCTATTGCGCCCATTTCTTCAGTAGAGTATTCTGTATCTGGTTCTTTGGTCACCCTGAAGT
ASV139	GGTACTGGTTGAACTGTTTACCCCCCGCGATCACTGATAGCCATTGCCATCTGGATTTCCCAGATTTTGCCGATGAGCTTGACACTATAATAAGCCGAGCGCAGGCCGCGGGCGTTCATCGCATGGTAACGATTTGTACAAAATTACAGAATGAACCCTCTGTACGCGCCATCGCCGCGCGATATGCACCTGTTTTTTACGCGGCTGGCACCCATCCGATGAGCGCAGCAGATGATTTTTTGGTCACCCTGAAGT
ASV140	GGTACTGGTTGAACTGTATACCCTCCTCCCAAAAAACATTTTTGCTCTCTGTCTAATACCTGCTTCAGTATTTATGAAAAAACTTTTAAACTCATTGTACTTAGCGATAACTAATAATACAGGCCTGCCATAATACTTGTCGGTCATTCTTTTTTAGGCTCTTCATTTTTATTATCTTCTGATTTTTTGGTCACCCTGAAGT
ASV141	GGTACAGGTTGAACTGTTTATCCCCCCAACCAATGAACTTTAAAAGCTCCCTCCGGAAAGATAGGATCTACATGCAATGTCACTCCTCCCTTCCCCGGGTTCTCATGTGTTTCATCGAATAATGTTTTAGCCTCATCAAAAAATGGCATTCGCCAATCATCAAAACCACCTATTTTACGTAGGTTTTTTCTATCGTTGTACTCAACTGCCTCATGCCAATTAACAAACTTACCCTTATCTTGCCATGGTTCTTTGGTCACCCTGAAGT
ASV142	GGTACAGGTTGAACAGTATATCCCCCGCGATCACTGATAGCCATTGCTATCTGGATTTCCCAGATTTTGCCGATGAGCTTGACACTATAATAAGCCGAGCGCAGGCCGCGGGCGTTCATCGAATGGTAACGATTTGCACAAAATTACAGAATGAACCTTCTGTACGCGCCATCGCCGTGCGATATGCACCTGTTTTTTACGCGGCTGGCACCCATCCGATGAGCGCAGCAGATGGTTCTTTGGTCACCCTGAAGT
ASV143	GGAACTGGTTGAACTGTTTACCCCCCAGCGTAAAGTGAGTCCACTAAATAAACTATTACCCCCAAGAACATTTTTCTCATTCCTGTAAACAGTATCAAAAGCATCAATTAGTTCTGGGTAAAAGATGAAGAACAAGTGGCGATGTAAAGTTTCAATCCCGACTCCCTTTCCTTTCGCCCATCGAACTTGTTTCAACAACCCATTTCCTTTTATAGCATTTCTATCAGGGGAGTATGGTTCTTTGGTCACCCTGAAGT
ASV144	GGAACTGGATGAACAGTTTATCCCCCAAAAAAACAACAATTTTAGTGACATACAAATTTCTGCACTAAGTAGCCTTTAAAAAATAATTGAAACAAAAATAGAATATTGAATATAGAAATGCATTTCTTCACTTTTAGAGACTAGGGTAGAAATTTGGAAAAAGGTTTGATTCTTTGGTCACCCTGAAGT
ASV145	GGAACAGGATGAACAGTATATCCTCCCCCCACCATGTCGCTCGCTTCATCGTTATTGTTTGTTGTTGGTTGTTGTTGGTGTCGTTGTTTGGTGTTTGTTGATGTTGTTGTGTGTTGTTGTTTGTTGGTTGTTGTTGTTTGTGGTGGTGTTGTTGTTGTGGTTCTTTGGTCACCCTGAAGT
ASV146	GGTACTGGATGAACAGTATATCCTCCATATACCATTTACGTCTAAAGTAGGTCTAATGCTCATTCTCTCATATGGAGTATAATCGGACTCCCCTTCATGCGCACCTATATCAATACTTGCTTTATGTGTTTCCTCAGAAAAAGGAGCCCTTGCCATAGCCGCTCTTTCATCGGAAGTGAGTTCTAAGACGTCGTCGTAGAATCCATCGACTGTGATTTTTTGGTCACCCTGAAGT
ASV147	GGTACAGGATGAACAGTATATCCTCCCCTTACTGACATTCTTCCTGCTCCACTTCCTGATCTTCATCCTGCTCCTCTTCCCAATCATCTTCCTCATCCCCTTCGAGATCTTCTTCCGAATTGTCGTCCCCTTCATTATCCTCTTCCCCTTCCTGCTACTCTTCCTGACTGTCTTCCTCATCCTTTTTATGCTCCACTCCCTAGTCCTCTTCCTGATCCTAATACCCTTCCTTCTCCTCTTCCCAAACTCCTTCCTGATTCTTTGGTCACCCTGAAGT
ASV148	GGAACTGGATGAACTGTTTACCCCCCTTAAGGTACATTAGGACCTTTTATACCTTTTTAAAAGGTATTATTTTACCTTTTTTAGGTATAAAAGCTTCTATTTAATTGAAACAAAAATTATTTACTGAAAAGACCTACAACCTCTTCTAAATGATTCTCAACGGTGTTTTATTATTCGTAAATGTATTTTATAACAATCTATTTACTTAGAAGCATTCAAAAATAATACTCTCCCCAAAATGGTTCTTTGGTCACCCTGAAGT
ASV149	GGTACTGGTTGAACTGTTTACCCTCCCTTTTGGAAGAAGTCCATAATTAAGCTGCATTTTTTTTTGAGAAGCTCCCTTACCTGCCTATGTTTTTTTTTTTTCATCATAGAAGAATTATAATGTACTACAGTGGCTACTTTGCCTGCTCCTAGTGCATTTATTTTACTGTTTTACCCACAAGCTATATAAATGAAAACTTTTTTCTTCTTGTTCTTCCACCCTATCTGTCTCTTTCTGTCTGTTTTGATTCTTTGGTCACCCTGAAGT
ASV150	GGTACTGGTTGAACAGTTTACCCCCCTCTGAGTTCTTATATTTTTCACGGGGGAGCATCGGTTGACTTTACAATTTTTAGACTTCACCTAGCCGGAGTTTCTTCTCTCCTAGGGGCTGTAAACTTTATTAGCACGGTTTTAAATTTACGGGCATTAGGTATGTTGATAGATCGCATACCTTTATTCCCATGGGCAGTATTTATTACTGCTATTCTGATTCTTTGGTCACCCTGAAGT
ASV151	GGAACTGGATGAACTGTTTATCCTCCATTCTGCAACCACAGCAACCTTTTCAGAAAAAGAAATCTAAAATGCTTGTTCGTACCTATCCTGAAAAGTCTAAAAAAGACTCTACCCATGTAAAAGACTTTGAATCAGTTCTCAGTCTGAATCTTGACAAAAACTCGAATAACACAGTTAGCTTTAAGTGGTTTTTTGGTCACCCTGAAGT
ASV152	GGAACTGGTTGAACAGTTTACCCCCCGCGATCACTGATAGCCATTGCCATCTGGATTTCCCAGATTTTGCCGATGAGCTTGACACTATAATAAGCCGAGCGCAGGCCGCGGGCGTTCATCGCATGGTAACGATTTGTACAAAATTACAGAATGAACCCTCTGTACGCGCCATCGCCGCGCGATATGCACCTGTTTTTTACGCGGCTGGCACCCATCCGATGAGCGCAGCAGATGATTCTTTGGTCACCCTGAAGT
ASV153	GGTACTGGTTGAACAGTTTATCCCCCTCTAAAATTCATATTGCTCATTTTCTAGAGATGACTTCATCAACTTCTAAAAGGCTTTTAGAAATACACATAGTGGCCGATACTTAACCTTACAAAGAATTTTAATTCAATTAGGGGACGTCCATATATAATGTTGCCAGTTTTTCCTGATTCTTTGGTCACCCTGAAGT
ASV154	GGTACAGGTTGAACTGTTTACCCTCCTCTAAGTTCTTATATTTTTCACGGGGGAGCATCGGTTGACTTTACAATTTTTAGGCTTCACCTAGCCGGAGTTTCTTCTCTCCTAGGGGCTGTAAACTTTATTAGCACGGTTTTAAATTTACGGGCATTAGGTATGTTGATAGATCGCATACCTTTATTCCCATGGGCAGTATTTATTACTGCTATTCTGATTCTTTGGTCACCCTGAAGT
ASV155	GGTACTGGTTGAACTGTATATCCCCCAGTACTTACAGAATCACGTGAACCACCCGGTACGGCTTGCTTAGTCAGTTGCTAATCATCATAAGGACGCGATTGACACAAAATTTTGTGAGAAAATCAAGGGGGGAAGAGGGCAAAACTGTCAGTGATTTTTTGGTCACCCTGAAGTTTAC
ASV156	GGTACTGGTTGAACTGTATACCCCCCGGTGTAGGCCTTATGAAAATGCCTTTATTTGTTTGGTCTTGGCTGATTACCGCATATCTTCTTATCGCTGTTATGCCTGTTTTGGCAGGAGCAGTAACAATGATGTTAATGGACATACATTTTGGGACAAGTTTCTTTAATGCAGCTGGCGGCGGCGACCCAGTTCTTTTCCAGCATATATTTTGATTTTTTGGTCACCCTGAAGT
ASV157	GGTACAGGATGAACTGTATACCCTCCTGTAGCCGTCTCTCGCGCTCTCCATTCACATTTTTCATCCTCATCACCTCACATAGTGTTGTTACCACCTTGTTAGGAATGGCGCCCTGCGCGCGCACGTTTCTGAATAAACTCCTCCTCCTCCTTGCTGACTGGTTGAAGTTAGGCTTAATTATGTGTGTTGTGTTTCGGTGTGGATGTTAGGATCGCTTGATTCTTTGGTCACCCTGAAGT
ASV158	GGTACAGGATGAACTGTTTATCCTCCACTAAATGAACCAACCATTGACCCCCAATTTTTTTTGCATCTATGGCTACTACCACACACTGCGCACCAAAAGCTTGCGATAATTCTTTAATAAGCTCTGGGCGCCTCACGGCCGACGAATTAATGGATACTTTATCTGCCCCATTCTTAAGGAGTATGTCTACATCTGCAACACTGCTTATTCCTCCCCCAACAGTAAAAGGAATGTCTACCGTAGCAGCTACTTTTAGCACTAAATCTGCCATGATTTTTTGGTCACCCTGAAGT
ASV159	GGTACAGGTTGAACTGTTTATCCTCCACCTTTTGAAAAGAAAGGAAGTTGCCACAACATGGGGTCCAAGCCAAGAAATATCCTCAGCATTCTCCTAGTAACTTTTAGTTGAAGATTTATCTAAAAGAAAAGAAAAATAATTTATGGATCAAACTCCATCGCATGACAGTGTTTAAGGTATGTGGTTTTTTGGTCACCCTGAAGT
ASV160	GGAACTGGTTGAACTGTTTACCCCCCTCTCGCTAGTCTCTGTCGTCTTCACCAAGGTCTCCCTTGTCCGTCCTCCCTCCTGTCCTCCTCTGATACTCTGTCCTCCTCTTATACTCTGTCCTCCTCTGATGCTATGTGCTCCTTTGATACTCTGTCCTCCTTTTGATTCTTTGGTCACCCTGAAGT
ASV161	GGTACTGGTTGAACTGTTTACCCCCCTCTGAGTTCTTATATTTTTCACGGGGGAGCATCGGTTGACTTTACAATTTTTAGACTTCACCTAGCCGGAGTTTCTTCTCTCCTAGGGGCTGTAAACTTTATTAGCACGGTTTTAAATTTACGGGCATTAGGTATGTTGATAGATCGCATACCTTTATTCCCATGGGCAGTATTTATTACTGCTATTCTGATTCTTTGGTCACCCTGAAGT
ASV162	GGAACAGGATGAACAGTTTATCCTCCGCGATCACAGATAGCCATTGCCATCTGGATTTCCCAGATTTTGCCGATGAGCTTGACACTATAATAAGCCGAGCGCAGGCCGCGGGCGTTCATCGCATGGTAACGATTTGTACAAAATTACAGAATGAACCCTCTGTACGCGCCATCGCCGCGCGATATGCACCTGTTTTTTACGCGGCTGGCACCCATCCGATGAGCGCAGCAGATGGTTCTTTGGTCACCCTGAAGT
ASV163	GGAACTGGATGAACTGTTTACCCTCCGATTTATCAATAGGGTATCTGATACCAAAAATGTCACATCGTCATTTCTGGCTCAGTAACAAAGATTCACTCCAGATTTAGTCTGAAATATCGAAAATCTGTGTATTTTACTATTTAAAGCCCTATTGCAGTCCAATTCTGTGATAGTCTGACCGAACGATTCTTGATTCTTTGGTCACCCTGAAGT
ASV164	GGTACTGGTTGAACTGTTTACCCCCCCGGCAATGCGCAATTGGTCCCAGAGGTTATTATTGCAGCCTTCCTTAGTCAGATTCCATGAAAATTCTTCTTTTCACCATCTAATCATTTGAGGTTGCCCTTTATGTATAAATCTTGGCTCTCAGTATATCTGTGATTTTTTGGTCACCCTGAAGT
ASV165	GGTACAGGTTGAACTGTTTATCCTCCACAACTTGTCATATGTCATGTGTCATATGTCACGTGTCACATGTAAAGTGTCACCTATCACGTGTCTCGTGTCACATGTCATGTGTCACATGTCACATTTTATTTTATCTTTTTTTAAATCTCTTTTTGGACAAGGTGGTGAAGCTTATTGGTGGAGGGTCTGTTATCAATGGGGCCTACCCTGTCTAGTTTCTTGATTCTTTGGTCACCCTGAAGT
ASV166	GGTACAGGATGAACTGTTTACCCCCCGCGATCACTGATAGCCATTGCCATCTGGATTTCCCAGATTTTGCCGATGAGCTTGACACTATAATAAGCCGAGCGCAGGCCGCGGGCGTTCATCGCATGGTAACGATTTGTACAAAATTACAGAATGAACCCTCTGTACGCGCCATCGCCGCGCGATATGCACCTGTTTTTTACGCGGCTGGCACCCATCCGATGAGCGCAGCAGATGATTTTTTGGTCACCCTGAAGT
ASV167	GGTACTGGTTGAACTGTATACCCTCCTCTGAGTTCTTATATTTTTCACGGGGGAGCATCGGTTGACTTTACAATTTTTAGACTTCACCTAGCCGGAGTTTCTTCTCTCCTAGGGGCTGTAAACTTTATTAGCACGGTTTTAAATTTACGGGCATTAGGTATGTTGATAGATCGCATACCTTTATTCCCATGGGCAGTATTTATTACTGCTATTCTGATTCTTTGGTCACCCTGAAGT
ASV168	GGTACTGGTTGAACAGTTTATCCCCCTCTGAGTTCTTATATTTTTCACGGGGGAGCATCGGTTGACTTTACAATTTTTAGACTTCACCTAGCCGGAGTTTCTTCTCTCCTAGGGGCTGTAAACTTTATTAGCACGGTTTTAAATTTACGGGCATTAGGTATGTTGATAGATCGCATACCTTTATTCCCATGGGCAGTATTTATTACTGCTATTCTGATTCTTTGGTCACCCTGAAGT
ASV169	GGTACTGGTTGAACTGTTTATCCCCCTCTGAGTTCTTATATTTTTCACGGGGGAGCATCGGTTGACTTTACAATTTTTAGACTTCACCTAGCCGGAGTTTCTTCTCTCCTAGGGGCTGTAAACTTTATTAGCACGGTTTTAAATTTACGGGCATTAGGTATGTTGATAGATCGCATACCTTTATTCCCATGGGCAGTATTTATTACTGCTATTCTGATTCTTTGGTCACCCTGAAGT
ASV170	GGAACAGGTTGAACAGTTTATCCCCCTCTTTCAAGAAATATTGCCCATGCTGGTGGCTCTGTGGACTTTGCCATTTTTTCTTTACACCTCGCAGGGGTAAGATCTATTTTAGGTGCTGTTAATTTTATTAGTACTCTAGGTAATCTGCGAGTATTTGGTATATTGCTAGACCAGATACCATTGTTTGCTTGATCCGTACTAGTTACAGCTATTCTTTTACTCCTTTCTTTACCAGTTTTAGCTGGAGCTAATATCAACATCTTTTTTGATTTTTTGGTCACCCTGAAGT
ASV171	GGTACAGGTTGAACTGTTTATCCCCCTGCCTTGCCTGCCTCCCTCTCTCCGCACTCACTCACTCACCTACTCACTCACTTACTCACTCACTCACTTTCTTGTACTTCTTCTCTTCTTCTTGCTGTTCTTGTTCATGCTATTAAGATGGCTTGCTTCTCCCCCTTGCTGATTTTTTGGTCACCCTGAAGT
ASV172	GGAACAGGTTGAACAGTATACCCTCCCCTGAACATGTTGCCTCAGCCTGGGATCCCTGAGGGTAGCCATGAAAAACTATTAAATTTCAAGCCTGTCTCCAGGACATCAAAAATCATAAAGAGGGCCACCACAAAACATACAAAATGCACACTAAAATCAGCAGAATTCCAACTTCTGCAACAAATTGATTCTTTGGTCACCCTGAAGT
ASV173	GGAACTGGATGAACTGTATATCCTCCTCTTTTGTCCTTCCGAGAGAGAATCACGGCTTCATTTCCTTAGCACTCTCACGAGGATCGTACTAGGTCGGGGCGTCCTTCGATTCCTGGAGTTACGATGCATTTGGAGCGACGGCATCGCTGCAAGACAGCGTGGTGACGTGACGCTGATATCACTGAACGACTTGTTTTATGGAATCGAGTGATTCTTTGGTCACCCTGAAGT
ASV174	GGTACTGGATGAACTGTTTACCTTCCTTTATCTGCAGGAATTGCCCATGCTGGAGCTTCTGTAGATATAGGAATCTTTTCACTACATATTGCTGGAGCTTCTTCTATTTTAGGGGCAATTTTACTTTTATTATCTATTCCAGTTTTAGCTGGAGCAATCACAATACTTTTAACAGACCGTAATTTAAATACATCTTTCTTCGACCCTGCCGGAGGTGGTGACCCTATTTTATATCAACATTTATTCTGATTTTTTGGTCACCCTGAAGT
ASV175	GGTACAGGATGAACTGTTTATCCTCCTGAATCTCTTAATATATCCTCCTGAATCTTTCTTCTGGGCCAGCTGGGTATTAACTCATATTGGTCCAAGCTAAGTGCGAGCACATTCACGATGATTTACAGAGATGGCAGGTAAATATAGTGACCACTATTTTTAAAGGTGCAGGGCAAACATAATGACCACAATTTTGATTCTTTGGTCACCCTGAAGT
ASV176	GGTACTGGTTGAACTGTTTATCCTCCTCTGAGTTCTTATATTTTTCACGGGGGAGCATCGGTTGACTTTACAATTTTTAGACTTCACCTAGCCGGAGTTTCTTCTCTCCTAGGGGCTGTAAACTTTATTAGCACGGTTTTAAATTTACGGGCATTAGGTATGTTGATAGATCGCATACCTTTATTCCCATGGGCAGTATTTATTACTGCTATTCTGATTCTTTGGTCACCCTGAAGT
ASV177	GGTACTGGTTGAACAGTTTATCCTCCTCTGAGTTCTTATATTTTTCACGGGGGAGCATCGGTTGACTTTACAATTTTTAGACTTCACCTAGCCGGAGTTTCTTCTCTCCTAGGGGCTGTAAACTTTATTAGCACGGTTTTAAATTTACGGGCATTAGGTATGTTGATAGATCGCATACCTTTATTCCCATGGGCAGTATTTATTACTGCTATTCTGATTCTTTGGTCACCCTGAAGT
ASV178	GGTACAGGTTGAACTGTTTATCCTCCTCTGAGTTCTTATATTTTTCACGGGGGAGCATCGGTTGACTTTACAATTTTTAGACTTCACCTAGCCGGAGTTTCTTCTCTCCTAGGGGCTGTAAACTTTATTAGCACGGTTTTAAATTTACGGGCATTAGGTATGTTGATAGATCGCATACCTTTATTCCCATGGGCAGTATTTATTACTGCTATTCTGATTCTTTGGTCACCCTGAAGT
ASV179	GGAACAGGTTGAACTGTATACCCCCCTTTGTGTGGATAAAACACCGTTTTTTAGGCACCACTCCCTAATATACTACATTTGAAAGCATCAGGTACACAACCATTAAATAAATGATTTGACCCTCATGGCATTGGTAGTATCTCAACTCTTGGAGTTTACTATAGAGATATCAGATAGCTTGGCTGAAGGCGGATTGTGCGTTATACATGATTGGTAAATAGTGTTGAAAAGGACCCTGCAATACTTGTGTAATATGTGCGGTGCGCAGCCCTGTGTTGGTTCTTTGGTCACCCTGAAGT
ASV180	GGAACAGGTTGAACTGTATACCCCCCATATACCATTTACGTCTAAAGTAGGTCTAATGCTCATTCTCTCATATGGAGTATAATCGGACTCCCCTTCATGCGCACCTATATCAATACTTGCTTTATGTGTTTCCTCAGAAAAAGGAGCCCTTGCCATAGCCGCTCTTTCATCGGAAGTGAGTTCTAAGACGTCGTCGTAGAATCCATCGACTGTGATTTTTTGGTCACCCTGAAGT
ASV181	GGAACAGGATGAACAGTATACCCTCCAGCTGACCGAGATCCTAGCAGCCGAAGTCCAGGAACCAGTTCGGCCGGACAACGCTCCGCCAACCTATGATGACGCCATGAAGTTTGTCAATGACGCATTTGCACTGGAACAGGTCTCACACGGTGTCAAGGCTCTTGCTCAAGCTCTTGCTGATGTATGTGTCTGTGTTGGTGTTTCTGCATGATATTGCCGATCTCCAGATTTCAAAAGGTCCAACAGGTCCAACAAAAAAATCTGGAGGGGCTCTATAATTGGGTGATTCTTTGGTCACCCTGAAGT
ASV182	GGAACAGGATGAACAGTATACCCCCCAGGAGAACTTCCCACGAAAGGTCAGCTATTCCTAGAAAGATTAAAGCAAATAGGACTACAAGAGTCGATTAAGGATTATCAGCAAGCATTAATTGATTAATTCCCGCTTTTCACAATACTTACCTTTTCAAAGCCTAACTCTTTCTATGATTTTTTGGTCACCCTGAAGT
ASV183	GGAACAGGTTGAACTGTATATCCTCCACCAAACTCATATGGTGGTGAACAAGTGGCCCAAAGTGCATCAGAATGGATTTGTGGATTTTTGTGATTTTTTTTGGATACCCTGGATCGTGGTAGCAAGACGGTCATTTTGATATACAACACTTGGGCCAATCTCCTCTCGGTCATGTGTATTTGTGGGTATTTGGGTGTATTTGGGTGTATTTGTGTATTCTACAAATACGATTTGTGGATTTTTTGTGATTTTTTGGTCACCCTGAAGT
ASV184	GGTACTGGATGAACTGTATACCCTCCCTCTCGGACGTTCGAACTCTTAGCTTTCGATGAATAATCCACTTTTGATACTTCCTGTGTAATCTTGCATCTAAGATATACAGCCCTAGTAAGTTATTATTTTCGTGCGGGGTGCTGCTGCTCCTCGCATTATATTGCGTTTGCAAGCAGAAGTATCAAAAAGGTTTTATTCACCGAAAGATAAGAGTTCAAACATCAGTGGTTTTTTGGTCACCCTGAAGT
ASV185	GGAACAGGATGAACAGTTTATCCCCCCATCAACATTTGCTTTTACATCAAATTTTCCTGATAAGTCAGCAATATTAAATGGTTGTTCTAATTTGTACTGCATAGTATCAACAGGAAAATATTCTTTGAAATCTTTACCGTTTACAGTAATATTTCCCTTTCCTTTTGACATGTAGATTCTGGCAACAGATGCTTTTCTTCTACCGATTGTGTGAATTATATCCATAATTATTTTAAGTCGTTTAAGTTAAGAGCTTTTGGTTCTTTGGTCACCCTGAAGT
ASV186	GGAACTGGATGAACTGTATACCCTCCTCCTGCCAAAGTCAAGCCAGGACAGAAAAATGAACCAGAGGAGGTTGCCCCTTACAGACTGGACATCCGGATAGGCAAGATTGTAGAGGTGTCCAAACATCCAGATGCCGAGAAGCTATACGTGGAGAAAATTGATTTGGGCGAGCCGAATCCTAGAACTATCGTCTCGGGATTAGTGGATTTTGTTCCCGAGGACAGAATGCTCAACAGGCTAGTTGTGATTCTTTGGTCACCCTGAAGT
ASV187	GGAACTGGTTGAACTGTTTACCCCCCACAGTGCAAAACATTTGTCACCTATTTTCCACTGCATTGTTTGTAAACTTTGCTACACCACTAAGATTAATTACTTTTCTGTTTTCTGTCTGTTTTCTTTCTGTTGAAGTGTTTGCGTTTCGCCCGAATCTATAGAGCAAGACACTCTTTTTACTTCCTTCAATTACATACTTGAGTTTAGTTCTGTTCTGGGTTTGCTGGTTCTTTGGTCACCCTGAAGT
ASV188	GGTACAGGATGAACTGTTTATCCCCCACGAATAATCACTAACTCTATTATTAATTAGCTTTTCAATAGACCTATTCATTGATAGTAAACACTCACTTTGATCAAATAGAGATTGATGAGATGGCTCTATATTTATAGATAAATAATCTGAATTGCTTTCTGAATTAAGACAGCAAAATATAACTGATTCTTTGGTCACCCTGAAGT
ASV189	GGAACAGGATGAACTGTTTATCCTCCACACAAAGGACGACAACAGGGTCACCGCCCATCGCCAGAACATCCCCAGTATGCGACCCTTCGAAGGCCAGCATGCTCCGCAGGGACCTCAAGATCAAGACGCCGACTCCCTCTCCAACCCCAACTCCGCTGGAGCCCTTTCCCTGGACCCCACATCTTCCCAAGCCCATGTACGTAAGCTGGGAGAGGAGCCCACACCCTTAAAGTGGTTCTTTGGTCACCCTGAAGT
ASV190	GGTACAGGATGAACTGTTTATCCCCCAACTCTTGCGCAACAAGGCAAAGTGGCAAATAGCCCGCACCAACGCCGCCAAAGGCTTCCGGGATCGCGGTACCTTGCAGCCCAAGCTCCGCCAAACCCTGCCAGACATCGCTGGCCTGCAGGGATTCTCCTTCCATGATCGATCGATGTCGGCTCAAGGGGCTCTGCTCGCTCAAAAATCTGCGAACCTGTTCTTGGATCATTCGATCCTCGCTAGAAAAATCAAAATTCATCGGTGTCTTTATTCCTCGTCAGTTGTTTTACTGGTTCTTTGGTCACCCTGAAGT
ASV191	GGTACAGGTTGAACTGTTTACCCTCCGCGATCACTGATAGCCATTGCCATCTGGATTTCCCAGATTTTGCCGATGAGCTTGACACTATAATAAGCCGAGCGCAGGCCGCGGGCGTTCATCGCATGGTAACGATTTGTACAAAATTACAGAATGAACCCTCTGTACGCGCCATCGCCGCGCGATATGCACCTGTTTTTTACGCGGCTGGCACCCATCCGATGAGCGCAGCAGATGGTTTTTTGGTCACCCTGAAGT
ASV192	GGAACTGGTTGAACTGTTTATCCCCCTTTAAGTAGTGCACAGGCTCATTCTGGGCCTGCCGTAGACCTTGCTATTTTCAGTTTACACTTATCAGGAGCCTCTTCTATTTTGGGAGCTATAAATTTCATCACAACCATTTTTAATATGAGAGCGCCTGGAATGTCTATGCACCGACTACCTTTGATTCTTTGGTCACCCTGAAGT
ASV193	GGTACAGGTTGAACTAGTTTACCCCCCTAACTATGCGCCTATTTAAGACTTGCTTTCGCTTCGGCTACGGACCTGAAGCCCTTAACCTTGCTAGAGAGGAGTAACTCGTAGGATCATTATGCAAAAGGCACGCCGTCGCCCGAAGGCTTCGACCGCTTGTAGACAGTAGGTTTCAGGTACTATTTCACTCCCTTTTTCAGGGTACTTTTCACCTTTCCCTCACGGTACTTGTTTACTATCGGTCTCTCAACATATTTAGCCTTACCAGATGGTTCTTTGGTCACCCTGAAGT
ASV194	GGTACTGGTTGAACTGTTTATCCTCCTCTGAGTTCTTATATTTTTCACGGGGGAGCATCGGTTGACTTTACAATTTTTAGACTTCACCTAGCCGGAGTTTCTTCTCTCCTAGGGGCTGTAAACTTTATTAGCACGGTTTTAAATTTACGGGCATTAGGTATGTTGATAGATCGCATACCTTTATTCCCATGGGCAGTATTTATTACTGCTATTCTGGTTCTTTGGTCACCCTGAAGT
ASV195	GGTACTGGATGAACTGTTTATCCTCCTCTGAGTTCTTATATTTTTCACGGGGGAGCATCGGTTGACTTTACAATTTTTAGACTTCACCTAGCCGGAGTTTCTTCTCTCCTAGGGGCTGTAAACTTTATTAGCACGGTTTTAAATTTACGGGCATTAGGTATGTTGATAGATCGCATACCTTTATTCCCATGGGCAGTATTTATTACTGCTATTCTGATTCTTTGGTCACCCTGAAGT
ASV196	GGTACTGGTTGAACTGTATATCCCCCACAGGCTGCTGTTGGGGTTAATTGCGCTGGTAATGGAAATCCTGGTTTAGCATTTACAGATGATATTGATCCAACTACTGGTTGGAGTGGAGATATTGGTACTGGTAATGGCATTTGGAGAATTAACTCTGGTGGAACTGATTCTTTGGTCACCCTGAAGT
ASV197	GGAACTGGATGAACTGTTTATCCCCCTCCGGTTTACACCAGCACTACGGGTTTGGAGAGGCAGTTGCCAAGACTCGCTGGATTCGTCACATCGCAGAGTTCGTCGGTTACCACTCTGTTCAGCCGATACGAGTCGAAAACGACAACATGGCCGCCTTATCCCTTGCCAGCATGCCTTTCATAGGAAAGGGTGTTCGGCACGCCTCAGTCCGGTCTCATTTCTTCAAGGAAGCCATCTTGGATGGGACCGTTGTCTTCGTCTGGCGTCCCACGCATCAGCTTCTGGCTGGTTCTTTGGTCACCCTGAAGT
ASV198	GGTACTGGTTGAACTGTTTATCCTCCCCCCTCTCCCGACGGCGACTGCTCAATCAGATCAGGCATTGGCAGGAACATTTCTTGTCACGGGACAAGTGAAGTGGTCTGACCTGCCCACAGGACACATGGCAGGCGGTCTCTACAGCCCCCACCCGGCTGCGGCCATCCGGCTGCGGCCACCCGGTTGCGGGGTTGGGACTGGCGGTGTCGGGAGCAGCATGCTTGATTCTTTGGTCACCCTGAAGT
ASV199	GGAACTGGTTGAACTGTATACCCTCCTCTTTCAAGAAATATTGCCCATGCTGGTGGCTCTGTGGACTTTGCTATTTTTTCTTTACATCTCGCAGGGGTAAGATCTATTTTAGGTGCTGTTAATTTTATTAGTACTCTAGGTAATCTGCGAGTATTTGGTATATTGCTAGACCAGATACCATTGTTTGCTTGATCCGTACTAGTTACAGCTATTCTTTTACTCCTTTCTTTACCAGTTTTAGCTGGAGCTAATATCAACATCTTTTTTGATTCTTTGGTCACCCTGAAGT
ASV200	GGTACAGGTTGAACAGTTTATCCCCCTGTTGGTGATGGCGCTTTACCTATGCTCGATGATGGCGGCTATGGCTCCATTACCTGTCGTAGAGGCCCAATCCCCGACTCCGATGATAACCCTTACCTGCAACTCGCTGACTATTGAAATTGATGTCGCACCAGGTAAAGACCGCAGTGGTTCTACCATGTGTTCTATCCAGAATCCAACTGCCTATGATGAGCAAGTCAGATTAGATATTGACCCATCTCCAGGTATCGCAGTTGCTGCCCCTGGTTTTTTGGTCACCCTGAAGT
ASV201	GGAACTGGTTGAACTGTATACCCTCCTCTTTCAAGAAATATTGCCCATGCTGGTGGCTCTGTGGACTTTGCTATTTTTTCTTTACATCTCGCAGGGGTAAGATCTATTTTAGGTGCTGTTAATTTTATTAGTACTCTAGGTAATCTGCGAGTATTTGGTATATTGCTAGACCAGATACCATTGTTTGCTTGATCCGTACTAGTTACAGCTATTCTTTTACTCCTTTCTTTACCAGTTTTAGCTGGAGCTAATATCAACATCTTTTTTGGTTCTTTGGTCACCCTGAAGT
ASV202	GGTACAGGATGAACTGTATACCCCCCGCGATCACTGATAGCCATTGCCATCTGGATTTCCCAGATTTTGCCGATGAGCTTGACACTATAATAAGCCGAGCGCAGGCCGCGGGCGTTCATCGCATGGTAACGATTTGTACAAAATTACAGAATGAACCCTCTGTACGCGCCATCGCCGCGCGATATGCACCTGTTTTTTACGCGGCTGGCACCCATCCGATGAGCGCAGCAGATGGTTCTTTGGTCACCCTGAAGT
ASV203	GGAACTGGATGAACAGTTTACCCCCCATATACCATTTACGTCTAAAGTAGGTCTAATGCTCATTCTCTCATATGGAGTATAATCGGACTCCCCTTCATGCGCACCTATATCAATACTTGCTTTATGTGTTTCCTCAGAAAAAGGAGCCCTTGCCATAGCCGCTCTCTCATCAGAAGTGAGTTCTAAGACGTCGTCGTAGAATCCATCAACTGTGGTTCTTTGGTCACCCTGAAGT
ASV204	GGTACTGGTTGAACAGTTTATCCTCCGGTACAGTTCGCACAATTATTTGCGCTTTCGTTAAATTATTTACTTAAAGCATTTATCATTTCTTGATAAGTTAAAATATAGTTTCCTAAAATAGCTAAGGAACATACAACCAGTACTGATAAACTAGCTATCGGTTTTAAAATTCTTATATTTCCTGCTGACATTATTTACTCCTTACTTTTGTAGGTTTTGATTTAGTTGGTTCTTTGGTCACCCTGAAGT
ASV205	GGAACTGGTTGAACTGTTTATCCTCCCTTGGTTGAAATCGGCAACAACGCCATCGAGGTCTATGCCGAGTCGTAGTTTTTTCATGACTATTGAGTGTTCCATACCTCTAGCGTTATGTCTCCATGGAGAGAACGATTTTTTTGCATTCGAATGCCGGCAGGTTGGCGGCTGGGGCGGCGGTGATTCTTTGGTCACCCTGAAGT
ASV206	GGTACAGGTTGAACAGTTTATCCTCCCCCAGACATGTGCGCCGAAAAATTTCCGCTAGTGTCGATGGGGGGCTGAGCAGAGGGTCTCGCGTGCGCAGAACCGGGAGCGAGGACCCCCATCGGCGCTAGCGGAATTAATCTTCTTTTCTTGTTGTTTTCTTGTTTTCTTGTTGATTCTTTGGTCACCCTGAAGT
ASV207	GGTACAGGTTGAACAGTTTATCCTCCTCTGAGTTCTTATATTTTTCACGGGGGAGCATCGGTTGACTTTACAATTTTTAGACTTCACCTAGCCGGAGTTTCTTCTCTCCTAGGGGCTGTAAACTTTATTAGCACGGTTTTAAATTTACGGGCATTAGGTATGTTGATAGATCGCATACCTTTATTCCCATGGGCAGTATTTATTACTGCTATTCTGATTCTTTGGTCACCCTGAAGT
ASV208	GGAACTGGATGAACTGTTTATCCTCCTTCCTTTGCGTACTTTTTCCTTGGGTTAATTTTTTCCCCCTCTATCTTATCCGCATGCGCCACAGCGGTTCCTGTACCTCGTTTTGTGTCGCCCCCGGCGTTGTATCTCGCATCGTGTGCCCCTGATTTTTTGGTCACCCTGAAGT
ASV209	GGAACTGGATGAACTGTATACCCCCCTGTGTTTCAATGTCACGGCGTGCTGCGTGGGCTGGAGGGCCGGTGATGGGAGAGGGAAAATAGGTTGGCAGAGAGAAGGAGGATGGGAACAAATAGATCCATACTGCTCCACATTCAAAGAGGGAGTTGCAAAAAGAAGAAATTGTAAAACTGGATTTACTTTCTTCAAATCAAGCTAATATTCGTGGCCAACCCCTTTACAATGACAATTACCTCTGATGATTTTTTGGTCACCCTGAAGT
ASV210	GGTACTGGATGAACTGTATATCCTCCGTCAATTGCTTGTTTTCTTCCTTTTTCATTTACAATCAATAATTTTTTCTTTCTATCTGCTTCTATTATTCTTGCATCAACTCCAGATAGTCCTATCGCATTAATTCCGTTTTTTTGTAACATTTGAACAATTGTTTTGTTTATTCTATCTGACATCACCATTGTAAAAATTTCGGCAGTTTCTTTGTCTGTATATCTGCTCTTAATTCCACTTGGGGATGTTACAAACTTTGGTTCTTTGGTCACCCTGAAGT
ASV211	GGAACTGGTTGAACAGTTTACCCCCCCCCCACAATTTAGAAGATTTGAATTGTTCTGTCTGTTCCCACCCTTAAAAATAGTCAGAACATGACTTACCTTAGTTGGTACATTATAGTGAGTATTCAACATTATTCAGCTGAAGATTCATTCTGGAACTTCAGATCACCCACAGGTTATGTTTTCACAAGTGGTCTGAGCTTTGATGTCCTTGGAATGTTCAGGAGCTCTTTGCCCTACATTCCAGCCTTGTTGCCCCTCCAGCCCTACACTGTGGTTCTTTGGTCACCCTGAAGT
ASV212	GGTACTGGATGAACAGTTTATCCCCCCCTATTCTTGATTCCCTCTTTCCTTGAAGTCTGCCCCATAATGGTTAGTTACTCGGACCGGTGGGACGACTCACAACAACTCAACACTCACTCGTCTTGGGTAATAATTATAATTAATTGGTCAAAGTGGTCATAGGGAAATCCCCGATGGTTCTTTGGTCACCCTGAAGT
ASV213	GGTACTGGTTGAACTGTTTCCCCCCCTAAATGTTTTTCCAGTGACAACTCAGCATCCTAAATTTATAAATCTAACCTTTTCATAAGAGCAAAGACAGTGCCAGGTGCAACATGGTTATACTATTCAAATAATATCAAGTAGTTAACCTTGATTCTTTGGTCACCCTGAAGT
ASV214	GGAACTGGTTGAACAGTATATCCTCCTGTTGGTGATGGCGCTTTACCTATGCTCGATGATGGCGGCTATGGCTCCATTACCTGTCGTAGAGGCCCAATCCCCGACTCCGATGATAACCCTTACCTGCAACTCGCTGACTATTGAAATTGATGTCGCACCAGGTAAAGACCGCAGTGGTTCTACCATGTGTTCTATCCAGAATCCAACTGCCTATGATGAGCAAGTCAGATTAGATATTGACCCATCTCCAGGTATCGCAGTTGCTGCCCCTGATTCTTTGGTCACCCTGAAGT
ASV215	GGTACTGGTTGAACTGTTTATCCCCCTTTAAGTAGTGCACAGGCTCATTCTGGGCCTGCCGTAGACCTTGCTATTTTCAGTTTACACTTATCAGGAGCCTCTTCTATTTTGGGAGCTATAAATTTCATCACAACCATTTTTAATATGAGAGCGCCTGGAATGTCTATGCACCGACTACCTTTGATTTTTTGGTCACCCTGAAGT
ASV216	GGTACTGGTTGAACAGTTTACCCCCCGCCAGAAACATTGATGTTCAGATCGTATTTATCTCTAAGGTTTAATACTTCCAAAGGTTTCATAGCGTGAATAACTAAAGATTCTCTTTTTAGATGTGAATCAATATTTAATTTTTTATTAACAGTAGAAGTTCCAGAACCGTCAGATAGATAAACTCTTGCAGTTGATTTTTTGGTCACCCTGAAGT
ASV217	GGTACTGGATGAACTGTATATCCCCCGCTTTAAATGTTCTGTAAGCGAGCGGATTTTTCCCCAAGGGTTATAAGTTGGATGACACCAACAATTTAAAATTAGATGGTTTAACAGCTGAAGGAATCATGGGCAATCTTAACTCATTAAATGGGAAGCCTTCGGTTTTTAATTTAACCCAAATCATGCAGATGTACCGCGGTAGATATCAATTAAAACCAGTAACTGCTCATGATTTTTTGGTCACCCTGAAGT
ASV218	GGTACTGGATGAACTGTTTACCCTCCCCTGCCCTTTCGCGGCGGAAATTTCCAATCTGCTGCGTTTCCTTTCTGTTTCTTCATCTGATTCATCTTTGCTGGCGCATGTTCTTTCTGCACGTCGCGCCATGTTCTTTGTTTCTCAACATGCGGTTCTTTGGTCACCCTGAAGT
ASV219	GGTACTGGATGAACAGTTTACCCTCCTCTTTCCAACGCCGATTATCACCCCACCCCGGCCGTTGACTTCGCTATCCTCAGCCTACATTTAGCGGGAGCATCTTCCATACTTGGTGCCATTAATTTCATAACGACGATTATTAACATGCGTGCGCCGGGTATGACTTTTCATCGCATGCCGTTGATTTTTTGGTCACCCTGAAGT
ASV220	GGAACTGGATGAACAGTTTATCCTCCGCGATCACAGATAGCCATTGCCGTCTGGATTTCCCAGATTTTGCCGATGAGCTTGACACTATAATAAGCCGAGCGCAGGCCGCGGGCGTTCATCGCATGGTAACGATTTGTACAAAATTACAGAATGAACCCTCTGTACGCGCCATCGCCGCGCGATATGCACCTGTTTTTTACGCGGCTGGCACCCATCCGATGAGCGCAGCAGATGATTCTTTGGTCACCCTGAAGT
ASV221	GGAACTGGATGAACTGTATATCCCCCTTCTACCAGCAGGAATAGGTTTGCCAAGGAGGCCGGTAAGAAAAGGGATAACTGTCTGTCTGTCAGTTAATCTGTCAGTCCGTCAGGAAGTCAGGAATTCAGATCAATGAGGCGGATCAAAGATTTGATCAGCCTAAAAAGAAGAGCTGAAGAGTCTCTACAGATTGGTTCTTTGGTCACCCTGAAGT
ASV222	GGAACTGGATGAACAGTTTATCCCCCTATAATTTACTGAATAAGTCCAATTTTCGGTCAAAAATCTAAATTTGGGCCGAATGACCCCCCCCTTAAAAAAAAATCGCGTCGCCCAGATTCTAGATTACAATTGAAGTTGGTCCCGGTAGACCTCAGCTTACTCTGATTTTTTGGTCACCCTGAAGT
ASV223	GGTACAGGTTGAACTGTTTATCCCCCTCTGAGTTCTTATATTTTTCACGGGGGAGCATCGGTTGACTTTACAATTTTTAGACTTCACCTAGCCGGAGTTTCTTCTCTCCTAGGGGCTGTAAACTTTATTAGCACGGTTTTAAATTTACGGGCATTAGGTATGTTGATAGATCGCATACCTTTATTCCCATGGGCAGTATTTATTACTGCTATTCTGGTTCTTTGGTCACCCTGAAGT
ASV224	GGTACTGGATGAACTGTTTACCCCCCTCTGAGTTCTTATATTTTTCACGGGGGAGCATCGGTTGACTTTACAATTTTTAGACTTCACCTAGCCGGAGTTTCTTCTCTCCTAGGGGCTGTAAACTTTATTAGCACGGTTTTAAATTTACGGGCATTAGGTATGTTGATAGATCGCATACCTTTATTCCCATGGGCAGTATTTATTACTGCTATTCTGATTCTTTGGTCACCCTGAAGT
ASV225	GGAACTGGTTGAACTGTTTATCCCCCTCTGAGTTCTTATATTTTTCACGGGGGAGCATCGGTTGACTTTACAATTTTTAGACTTCACCTAGCCGGAGTTTCTTCTCTCCTAGGGGCTGTAAACTTTATTAGCACGGTTTTAAATTTACGGGCATTAGGTATGTTGATAGATCGCATACCTTTATTCCCATGGGCAGTATTTATTACTGCTATTCTGATTCTTTGGTCACCCTGAAGT
ASV226	GGTACAGGATGAACAGTTTACCCCCCTCTGAGTTCTTATATTTTTCACGGGGGAGCATCGGTTGACTTTACAATTTTTAGACTTCACCTAGCCGGAGTTTCTTCTCTCCTAGGGGCTGTAAACTTTATTAGCACGGTTTTAAATTTACGGGCATTAGGTATGTTGATAGATCGCATACCTTTATTCCCATGGGCAGTATTTATTACTGCTATTCTGGTTCTTTGGTCACCCTGAAGT
ASV227	GGAACTGGTTGAACTGTTTACCCTCCTTTAAGTAGTGCACAGGCTCATTCTGGGCCTGCCGTAGACCTTGCTATTTTCAGTTTACACTTATCAGGAGCCTCTTCTATTTTGGGAGCTATAAATTTCATCACAACCATTTTTAATATGAGAGCGCCTGGAATGTCTATGCACCGACTACCTTTGATTCTTTGGTCACCCTGAAGT
ASV228	GGAACAGGATGAACAGTATACCCTCCAACATACACTAGCCCCCCAAATCTTGTATTTTTTTGTAAAATTGCATCATGTAGTAGTGTACTATGGATATATTAAATCATAAGGTGTTATTAGACATGAATTTTGATGAATTCTTATCTATCTATTGATGATGGTAAATTGAATCCCTGGTTAGTGTGATTCTTTGGTCACCCTGAAGT
ASV229	GGTACTGGGTGAACAGTTTATCCTCCGTCAATTGCTTGTTTTCTTCCTTTTTCATTTACAATCAATAATTTTTTCTTTCTATCTGCTTCTATTATTCTTGCATCAACTCCAGATAGTCCTATCGCATTAATTCCGTTTTTTTGTAACATTTGAACAATTGTTTTGTTTATTCTACCTGACATCACCATTGTAAAAATTTCGGCAGTTTCTTTGTCTGTATATCTGCTCTTAATTCCACTTGGGGATGTTACAAACTTTGGTTCTTTGGTCACCCTGAAGT
ASV230	GGTACTGGTTGAACTGTTTACCCTCCCCCTACTAAATTTTCGTTGCAATCTCAGACGATATATTCATGGCTGGTCCGCCATCTGATATTGCTCGTGCCTTCGAGGACTGGGCCGAGCTCGCCACACAAGACCACGGCCGTGTCAACTACAGCAAATGCGGGTTCTACTCTACTGACCAGAACAGCCTGAGCAACGCAGACATTCAAGCCCTTAGCACCGCCGACCCCAATCGCCGGGTGGACATTCGGCCACCATCTCAGGGCCTAGTGATTCTTTGGTCACCCTGAAGT
ASV231	GGTACAGGATGAACAGTTTACCCCCCATGCCCTCAAGTACTGTCTTACAGTGGAGAAACCGTATGTGTGTGTATATGTGTATGTACGATGACTGCAGACAGATCCAGGACAGCTGAGAGGCTGAGAGGCTGAGGGGCCGAGGGGCCCAGGCATGGGCCTTGGAAATCATACGAGTGCTGTGATTCTTTGGTCACCCTGAAGT
ASV232	GGAACAGGATGAACTGTATATCCCCCCCTCATATTTAGGAACAATAGCATTTCTGTCTAATTTGCTGATGTTAGGTTGTGGCCTTTGGGCCAAACCTCCAGCCAAGTATAATAGTGCACACACTAACTTTTATGGGTTTACCTAAACGGACCCCCAATAACCAAACCTAATCAAAATGGCAATATCTCAGGAACCATAGTAGCTACAAAAATTGGCATATACTATACAATTACATACTGATAAGTGGTTCTTTGGTCACCCTGAAGT
ASV233	GGTACTGGATGAACAGTATATCCCCCGCTCCGATGTCTTCCTGATCCACTTCAGCTTGATTTACTCCCGCTCCTCTGTTGCTCCGGGTACATCTTCCTTCCCTCTCTGGTTGGATTATGTTCCCTTTATCACAGTTGCTCCATCCAGGTCCATCCATCAGGGCCGTTCTTCTTGGTTTTCTTGCAGCGGGGATTCGTCTCGCTGGGCTGTCTTCTCTTGCTGGAGGCTCTGCCTCTTGCTGTTGCTCTGATTCTTTGGTCACCCTGAAGT
ASV234	GGAACTGGTTGAACTGTTTACCCCCCTCTGAGTTCTTATATTTTTCACGGGGGAGCATCGGTTGACTTTACAATTTTTAGACTTCACCTAGCCGGAGTTTCTTCTCTCCTAGGGGCTGTAAACTTTATTAGCACGGTTTTAAATTTACGGGCATTAGGTATGTTGATAGATCGCATACCTTTATTCCCATGGGCAGTATTTATTACTGCTATTCTGATTCTTTGGTCACCCTGAAGT
ASV235	GGTACAGGTTGAACTGTTTATCCCCCTCTGAGTTCTTATATTTTTCACGGGGGAGCATCGGTTGACTTTACAATTTTTAGACTTCACCTAGCCGGAGTTTCTTCTCTCCTAGGGGCTGTAAACTTTATTAGCACGGTTTTAAATTTACGGGCATTAGGTATGTTGATAGATCGCATACCTTTATTCCCATGGGCAGTATTTATTACTGCTATTCTGATTCTTTGGTCACCCTGAAGT
ASV236	GGTACAGGTTGAACTGTATATCCCCCTCTGAGTTCTTATATTTTTCACGGGGGAGCATCGGTTGACTTTACAATTTTTAGACTTCACCTAGCCGGAGTTTCTTCTCTCCTAGGGGCTGTAAACTTTATTAGCACGGTTTTAAATTTACGGGCATTAGGTATGTTGATAGATCGCATACCTTTATTCCCATGGGCAGTATTTATTACTGCTATTCTGATTCTTTGGTCACCCTGAAGT
ASV237	GGTACTGGATGAACTGTTTATCCTCCCTTCTTCCCAAAGCTCTTCATCCCTGACCGTGATCAGGGTGTTTGCCATCAATACCCAGTTATCCCTAACGTTCTGCTCGGCCTTCTGTATTGTTTCTGTCGCTTCAATGAGCGTCGAAACCTTTTGCATCGCTTCCATGCTTCTTCCTTTCAGTTGAGTCAGCCCCAGGGATTGTCTTCCCAAGGGTCAGCTTCTTTCTCTGATTTTTTGGTCACCCTGAAGT
ASV238	GGAACAGGTTGAACTGTTTATCCTCCTCTTATAGTTATAGAGGTAAACAAGACCAAGGTGATCTGTGCCGATCTCCTGGATTTTGTTTGTGACTAAGATTTGAATTTTATGACATTTTTTTTGTCCCAAGAGGTTGCGTGATTTTTTTTGTTCCCAGAGGTTGCGTGATTCTTTGGTCACCCTGAAGT
ASV239	GGTACAGGATGAACTGTTTACCCTCCAAACATAATCTGGTACTTCAAGATGAGATGAAAAATCTTTTTTCAAATCAACTAATTCATCTTTATTAGGGAGGCGACCCGTGAGGAGTAAAAAGAAAACTTCTTCAGGTAAAATATGGGCGATTTCTAAAAGTGGAATACCACGAATGATCAATCCTTTATCAGCCGAGACTGATGACGTATCACATACAAATGCTTTGATTCCCCGTAAACCGGAAAAAGCTTGGGCCACTGTAACATCACTGATTCTTTGGTCACCCTGAAGT
ASV240	GGTACTGGTTGAACTGTATATCCTCCTCTTTCAAGAAATATTGCCCATGCTGGTGGCTCTGTGGACTTTGCTATTTTTTCTTTACACCTCGCAGGGGTGAGATCTATTTTAGGTGCCGTTAATTTTATTAGTACTTGCTTGATCCGTGCTAGTTACAGCTATTCTTTTACTACTCTCTTTACCAGTTTTAGCTGGAGCTATTACTATACTACTAACTGACCGAAACTTAAACACATCTTTCTATGATGTGGGTGGGGGTGGGGACCCTATCTTGTACCAACATCTTTTTTGGTTCTTTGGTCACCCTGAAGT
ASV241	GGTACTGGTTGAACAGTTTATCCCCCTTTAGTAGCGAGCATCGCCCACGTGGGGGCCTCCGTATACGAACTACTGGCATAACAATAAACCGAATGACTTTATTCGTCTGATCGGTATTTTTAACAGCTATTTTACTACTCCTATCCCTTCCCGCCATTGCCGGAGCCATCACAATTCTTCTAACAGGTCATAATTTAAATACCTCTTCCTTTGACCCGGTGGAAGGAGGGGACCCTATCTTATACCAGCACTTATTTTGGTTTTTTGGTCACCCTGAAGT
ASV242	GGAACAGGATGAACTGTATACCCTCCACTCTTCTGGAAAATATGAAAATGTAACTTGCATGGTACCTTTGTTGTCCCCCATTTTTAGTCGAACTGGTTGACTGATCATTCTTGGTTTCTTGTCTCCTTGTTTTGGATTACACGTTACAAATGTGGGATCATATGGCATTACATCTATGATTCTTTGGTCACCCTGAAGT
ASV243	GGAACTGGATGAACTGTATATCCCCCAGGCATATCACTAGCAAAATACATTCTTTCACCGTTTTCTGTAATTGTAGGATGCATAACAGAGTAATGATCGTCATTAATAGACAAACCTAAGACACTGTCAGGATTATTAATATTGTTTAGATCGACCTTGAATAAATTAAGGTATAATGCTTCGTCTTGAGACTCTACACTAGTACTTCTTGTATAGTAAATGATTCTTTGGTCACCCTGAAGT
ASV244	GGTACATGATGAACAGTTTACCCTCCCAAAAAAAAAAATTGAATAAAAAATAAAAACAAGACCAAGGTGATCTGTGCCGATCTCCTGGATTTTGATTGTGACTAAGATTTGGATTTTTAGGAAATTTTTGTGTCCCAAAATGTTGCGTGATTTTTTTCTTCTTCAAGAGGTTGCATGATTCTTTGGTCACCCTGAAGT
ASV245	GGAACTGGTTGAACTGTTTACCCCCCGGGTACTTTGGTTTGACGTGTTTTTTTGGAAGGTCATAGGCTGTAGAATACACCCCTTGTTGCCATCAGTGATCCTATGAGACATTATCATCCCAAGGATCGAAAAATTATGTTAAACTATATAGATTACACCCTGATTACATTAAAAACTGAAATTGCCAAAATTATAAATAATAACATTTGTTGTGGTTTTTTGGTCACCCTGAAGT
ASV246	GGTACTGGTTGAACTGTTTACCCCCCCCAGTCAAAAAATATGACAGTTTTTATTTTCTTTCTTCAGAAGTTAGTGGATATCAAACATTTATGAAAATACTTTTAATATCAATTTGCCCCTATTACATCACTTCTGATATTTCCTCCCCCCTTCACCCTACCACTCTTGACTTCAAGACCATTTACCATATCTTGGTAGGTCAGACAGAAACTTTCAATATAACTAAAAGAAGCCAAATTCTTTAGATGGCCTCTTGGTTCTTTGGTCACCCTGAAGT
ASV247	GGAACTGGTTGAACAGTTTATCCTCCACCCCAGACATGTGCGCCGAAAGATTTCCACTAGTGTCGATGGGGGGCCGAGCGGAGGGTCTCGCGTGCGCAGACCCGGGAGCGAGGACCCCCATTGGCGCTAGCGGAATTGAGTTTAAAATTCTAATTTTCAAGCTGTTAGCAGATCAATGAACCATAAAGCAGCTAAATTTACCTATAAATTAACTTTTGTACACATATGGCTGATTTTTTGGTCACCCTGAAGT
ASV248	GGTACTGGTTGAACTGTTTACCCCCCTCTGAGTTCTTATATTTTTCACGGGGGAGCATCGGTTGACTTTACAATTTTTAGACTTCACCTAGCCGGAGTTTCTTCTCTCCTAGGGGCTGTAAACTTTATTAGCACGGTTTTAAATTTACGGGCATTAGGTATGTTGATAGATCGCATACCTTTATTCCCATGGGCAGTATTTATTACTGCTATTCTGGTTCTTTGGTCACCCTGAAGT
ASV249	GGAACTGGTTGAACAGTTTATCCCCCTCTGAGTTCTTATATTTTTCACGGGGGAGCATCGGTTGACTTTACAATTTTTAGACTTCACCTAGCCGGAGTTTCTTCTCTCCTAGGGGCTGTAAACTTTATTAGCACGGTTTTAAATTTACGGGCATTAGGTATGTTGATAGATCGCATACCTTTATTCCCATGGGCAGTATTTATTACTGCTATTCTGATTCTTTGGTCACCCTGAAGT
ASV250	GGTACTGGTTGAACAGTATACCCTCCTCTGAGTTCTTATATTTTTCACGGGGGAGCATCGGTTGACTTTACAATTTTTAGACTTCACCTAGCCGGAGTTTCTTCTCTCCTAGGGGCTGTAAACTTTATTAGCACGGTTTTAAATTTACGGGCATTAGGTATGTTGATAGATCGCATACCTTTATTCCCATGGGCAGTATTTATTACTGCTATTCTGATTCTTTGGTCACCCTGAAGT
ASV251	GGTACTGGATGAACAGTTTACCCCCCTCTGAGTTCTTATATTTTTCACGGGGGAGCATCGGTTGACTTTACAATTTTTAGACTTCACCTAGCCGGAGTTTCTTCTCTCCTAGGGGCTGTAAACTTTATTAGCACGGTTTTAAATTTACGGGCATTAGGTATGTTGATAGATCGCATACCTTTATTCCCATGGGCAGTATTTATTACTGCTATTCTGATTCTTTGGTCACCCTGAAGT
ASV252	GGTACTGGATGAACTGTATACCCCCCTCTGAGTTCTTATATTTTTCACGGGGGAGCATCGGTTGACTTTACAATTTTTAGACTTCACCTAGCCGGAGTTTCTTCTCTCCTAGGGGCTGTAAACTTTATTAGCACGGTTTTAAATTTACGGGCATTAGGTATGTTGATAGATCGCATACCTTTATTCCCATGGGCAGTATTTATTACTGCTATTCTGGTTCTTTGGTCACCCTGAAGT
ASV253	GGAACTGGATGAACTGTTTATCCCCCCTGTCTCACATCTCTTAATTTTTGGACAACAATTCTAAATCTGAGATCTTATTATCTGACATTAAAGATTATGCCATTATTTTCATGGGCTCTTTTGATAACAGCAGGAATGCTTTTGTTAACATTACCAATCTTATCTGGTGCTCTTTTAATGATCTTGGCCGATCTTCATTCTAATACACTTTTCTTTGATCCAATTTTTGGAGGAGATCCTATATTCTATCAACACTTATTTTGATTCTTTGGTCACCCTGAAGT
ASV254	GGTACAGGATGAACTGTTTATCCCCCCCGTGTATCGTATTTCCTTTTCTCCTCGCGTCTCTTCTCTGCTCTTCTCTTCTCTTCGCGTCTCTTCTCTTCTCTTCATCTCTTCCCTGTTCTGTTCTTGTCCAGTCCTGTCCTGTCACGTTTCCCTGTTCTGCTCACACCTGTTATCTTTCTTTTCTTATCTTTTCTGTTATCGTCGTTCCGTTTGCCTTCTGATTTTTTGGTCACCCTGAAGT
ASV255	GGTACTGGATGAACTGTTTACCCCCCCCTTCCTTGCATGTTGGGCTTCCGTGTCTGGTCATGTTCCTGGCGTGTCCATGGGTCGGGCGTGTCTTTGTCCGCCGGGTCTTGAGGCTTCCCGCCGACCGCGTTGTCTCCGCTGTCTCCCGGGTCCCTTGCCGTTCTGAGGCAGAGTGTTAGGCTGGCTCCTGGTTGGATCTGGCATTGCTGTAGTGTGCAGGCATCTGGCAGGCGTTGGTCTTTGGATACCAGGTGATTCTTTGGTCACCCTGAAGT
ASV256	GGAACAGGATGAACTGTTTATCCCCCCAGCTCAACTCTTCTTTGTTTAAAAGCTTCATTCGGAGGTCTTCAAAACCTTCATGTAAGTCTTTTGCGAGCTGAACATTTTGCTCTAACTGTTTTTTAAGTGTTTTAGTTTTTATCTCTTGTTGTTGTTGTATTTCTTCTTCTGTGGGCGCGTTAAACTCAAAAGCTCTGCTTTGACTTTTTTTAGAGCCATTTACGGCGTCATTATCATAAACTTCAAAGTAATATTCGAGAGTTTCTCCCTCGTTGATTTGAATGGTTTTTTGGTCACCCTGAAGT
ASV257	GGTACAGGTTGAACTGTTTATCCCCCTCTCTCGGGGTTCTGTGACCTTTGAGTCCACCTTCCAGGGCGGCCTCTTCAGCTTGGTATCTCGTCTCTTCATCACAGAAAGTGATTGTGATGGGGATGAAGTCGGGGTGACGAGTGTTTTTCCATTGTCTTACGGATCCAACCACGTCTCCATTTTTGAAGGTGTAGCCGTAGTTCTTGAGTTCCCTTAGGAATTTCGTTGTCCTTGCTCTATCTGGTTTTTTGGTCACCCTGAAGT
ASV258	GGAACAGGATGAACAGTTTACCCCCCCATATACCATTTACGTCTAAAGTAGGTCTAATGCTCATTCTCTCATATGGAGTATAATCGGACTCCCCTTCATGCGCACCTATATCAATACTTGCTTTATGTGTTTCCTCAGAAAAAGGAGCCCTTGCCATAGCCGCTCTTTCATCGGAAGTGAGTTCTAAGACGTCGTCGTAGAATCCATCGACTGTGATTCTTTGGTCACCCTGAAGT
ASV259	GGTACTGGATGAACAGTTTACCCCCCTGCTTTTTGACATACTCCTTTCTTTGTGCCTTTTGAGACAGGTTTTCTTCTTTATGTGGACTGTGGTGTGTACTGTGCCGTCCTACCAGAATGTGGTTTCTGGTTTGTGCTTTTTTGGGGAAGTCCTGTGGGAATGTGGTTTGTGGTTTGTGTTTTGTTGGGGAAGTCCTGCCGGAATGTGGTTTGTGGTTTGTGGTTCTTTGGTCACCCTGAAGT
ASV260	GGAACTGGATGAACTGTTTACCCCCCCACACACAGAGCCTGATGCGCAATAATGTGAGTCAACGAGACATGGGATGCCGAGGGGCTTGCAGAAGCCGGTAGGGCCAGACACATGTGCGGTCATGCTTGCTCAGCCCCAGTAGGTGAGCCGTCACGGCCTTCCATACCTCGCTGCCCCCCCAAGCATCCACATGTTGATTCTTTGGTCACCCTGAAGT
ASV261	GGTACTGGTTGAACTGTTTATCCCCCTGCAGACAGCACCCGCAAGAAGAACAAGTCCAACAAAGGCGACGGACAGGATCACGTACACAAAGGCCTACAAAAAGAAAAAAAACCAACATTAAGAAACGTAAAGAGAAGCCTTTTTTATCCCTAAAAAGGAAGTCCCTTTCTCACCTCCGTGGTTCTTTGGTCACCCTGAAGT
ASV262	GGTACTGGATGAACAGTATACCCTCCCCTCACCTAACCAAATCCAACGAAGAAGATTTTTTTTTTGTATATCTCTTTCTGTATTGGTGTGTTTATCCGCATCGGTCGAGAGATTCGTTGTCTCCCGTATGCGGGATTTTTATGTTAATAGTAAACTATTTTGTTCAGTACTCTGTGACCGTACCACTAAAGCTACTCTAGCACAATTAACATATGGTTCTTTGGTCACCCTGAAGT
ASV263	GGTACAGGATGAACTGTTTACCCCCCTCTGAGTTCTTATATTTTTCACGGGGGAGCATCGGTTGACTTTACAATTTTTAGACTTCACCTAGCCGGAGTTTCTTCTCTCCTAGGGGCTGTAAACTTTATTAGCACGGTTTTAAATTTACGGGCATTAGGTATGTTGATAGATCGCATACCTTTATTCCCATGGGCAGTATTTATTACTGCTATTCTGATTCTTTGGTCACCCTGAAGT
ASV264	GGTACAGGATGAACAGTTTATCCTCCTCTGAGTTCTTATATTTTTCACGGGGGAGCATCGGTTGACTTTACAATTTTTAGACTTCACCTAGCCGGAGTTTCTTCTCTCCTAGGGGCTGTAAACTTTATTAGCACGGTTTTAAATTTACGGGCATTAGGTATGTTGATAGATCGCATACCTTTATTCCCATGGGCAGTATTTATTACTGCTATTCTGATTCTTTGGTCACCCTGAAGT
ASV265	GGTACTGGATGAACCGTTTACCCCCCACAGCACATCTGCCAAACTACTTCCAGCCTAAACTCTGGCCAAGCTCACAGCACATCACACAGCAAAGCACATCTGCACAAAAGATCAGGCTCCCTGCCCCTAGCACACTTATAGTGGGTGTCTGGGCACCAACAACCATACATCTAGTTACTACTCTCCTTAACCCTTCTCATTCACCTAAGCTCCAGATTTCCCGTGACCTCCCAGTCTGGATGGGTCTATATTTTGGTGATTCTTTGGTCACCCTGAAGT
ASV266	GGAACAGGTTGAACAGTATATCCCCCAACTCTTGCGCAACAAGGCAAAGTGGCAAATAGCCCGCACCAACGCCGCCAAAGGCTTCCGGGATCGCGGTACCTTGCAGCCCAAGCTCCGCCAAACCCTGCCAGACATCGCTGGCCTGCAGGGATTCTCCTTCCATGATCGATCGATGTCGGCTCAAGGGGCTCCGCTCGCTCAAAAATCTGCGAACCTGTTCTTGGATCATTCGATCCTCGCTAGAAAAATCAAAATTCATCGGTGTCTTTATTCCTCGTCAGTTGTTTTACTGATTCTTTGGTCACCCTGAAGT
ASV267	GGTACTGGATGAACTGTTTATCCTCCAGCCATATTCTGCAACACATACAAAATACAAAGTCCGAGTGTACCAAGAAAATACCAAGCTGGACGCCATACTGACGGTGGAAGAGGGCTTACGAATTTTAAGAGAGCGGCGCCGATTAGTTTTTTGCGCGGCTCACCGGTTGGGTGCCTGAATCTGAACTTTGTGCCTCGCGCGTCGCATGCGATTGTGACGACCGTATGTGCCATTCGGAACCTTCACCACGGAAAAACGACACCTACACCATGATTCTTTGGTCACCCTGAAGT
ASV268	GGTACAGGTTGAACAGTTTACCCTCCCAGGATCCAAATTAGGGACGTTGTGACTTCTAGTTCTTGGGGGGATCATCGAAAATCAAAATTCGGACTTCGTCATGGCATAAATCTCGATGAGCTTTATGCCATGACGAAGTCCGAATTTTGATTTTCGATGATCCCTCCGAGAACTAGGAGTCACAACGTCCCTAGTTTCGTTCCGCTCAACTCTACAGTACGTACCATAATATACAGGGGAGGGTCGCTAGGAATGATTCTTTGGTCACCCTGAAGT
ASV269	GGTACTGGATGAACTGTATACCCCCCGTGAAATGTAATGTCAGTCAATGAGATTTATCAAAATTCCTAGAATAAAAGCATCATGTCATACTGGTCCTTCTTTATCTTGTCTAGTAAAAAATTTCATTTTAAGCATCCATAGTCTTTTTTTTTTGGCTTCAATTCTTTCATAGTACTCATATGGTTTTTTGGTCACCCTGAAGT
ASV270	GGAACTGGATGAACTGTTTATCCTCCTGCTCTGGAGACGTGTTCCTTCTTGTGAGGCTTGTGCATTCCTACCCTGCAACAAACATTCTTACTTTATGCTTGACCCACTCTTGCGAGACTTGCTGTGATGGATTTATTGTTCATCGTATTGTGCTTGTCGCCTAGCTTGACACCTCACACATGTATTTATGCGGTATTGTTTCGGCGGTTTCTTTGGCGCCCTTTCGGTGGAGTGGTGAGCCTGTAGTGTCTTCCCTCTGCGGTCGGTATTGATTCTTTGGTCACCCTGAAGT
ASV271	GGAACAGGTTGAACAGTATATCCCCCAGACTGAGACATGTTTAATGTTTCCATAACAACACCCTGACCTGAAAAGGCAGCATCACCATGAATAAGAACAGGCTAAACCTTTTGACGATCTGAATCCCCGATAATATCTTGATGGTATCGAGCGTAACCTTCAATAACTGGATTAACTAACTCCAAGTGAGAGGGGTTAAACATCAAAGCAAGGTGAACATTGTTTTTTTCTGTTTTAATATCTGAAGAAAAACCTTGGTGATATTTCACATCACCCGTTTGATTCTTTGGTCACCCTGAAGT
ASV272	GGAACAGGTTGAACAGTTTATCCTCCGTCAATTGCTTGTTTTCTTCCTTTTTCATTTACAATCAATAATTTTTTCTTTCTATCTGCTTCTATTATTCTTGCATCAACTCCAGATAGTCCTATCGCATTAATTCCGTTTTTTTGTAACATTTGAACAATTGTTTTGTTTATTCTGCCTGACATCACCATTGTAAAAATTTCGGCAGTTTCTTTGTCTGTATATCTGCTCTTAATTCCACTTGGGGATGTTACAAACTTTGATTTTTTGGTCACCCTGAAGT
ASV273	GGTACTGGTTGAACTGTATATCCTCCGCGTCGGTTACATACGAGGTTCCATCCTTGATCGTCACCTGGGATTTGTTCTGTTGTCGGCGAAATGATTTGTCTTGTTTGCGATTCTTTGCTTATTTTCTTGGTTTCATGGTCGTCATTTTCTTGATCTGATTCATTGGCGTCTCCTTCTGATTCTGGTTTTTTGGTCACCCTGAAGT
ASV274	GGAACAGGTTGAACTGTTTATCCCCCAGCGTAAAGTGAGTCCACTAAATAAACTATTACCCCCAAGAACATTTTTCTCATTCCTGTAAACAGTATCAAAAGCATCAATTAGTTCTGGGTAAAAGATGAAGAACAAGTGGCGATGTAAAGTTTCAATCCCGACTCCCTTTCCTTTCGCCCATCGAACTTGTTTCAACAACCCATTTCCTTTTATAGCATTTCTATCAGGGGAGTATGATTTTTTGGTCACCCTGAAGT
ASV275	GGTACAGGTTGAACTGTATACCCCCCTGCTCCTGTATCAAGCTCAACGCTGCCGTATTGTTTTGCGATTGACCATCTTACCTCCCTGCTCCTGTATCAAGCTCAACGCTGCCGTATTGTTCTGGGCGATCGCATGCTCGACTTTTCGAATTTTCTGGGTCACGCGTTTCACCCCCTCGCTACTCTCGATCTGCCCCAGTTTGGTTCTTTGGTCACCCTGAAGT
ASV276	GGTACTGGATGAACAGTTTACCCCCCTGGTCAACTTTTTGCCTTTAACCAATCCTTAACCTTAACAAAAACCAATCTGAAGCAAATCTTTAGCTAAGCTAAGCTTGTTATTGTATGGATTGGTACGAAAGAGGGAGATATGCAGAGTAAAGATGAATCCTGGTATTGATTCTTTGGTCACCCTGAAGT
ASV277	GGTACTGGTTGAACAGTTTACCCTCCTCTGAGTTCTTATATTTTTCACGGGGGAGCATCGGTTGACTTTACAATTTTTAGACTTCACCTAGCCGGAGTTTCTTCTCTCCTAGGGGCTGTAAACTTTATTAGCACGGTTTTAAATTTACGGGCATTAGGTATGTTGATAGATCGCATACCTTTATTCCCATGGGCAGTATTTATTACTGCTATTCTGGTTCTTTGGTCACCCTGAAGT
ASV278	GGTACTGGTTGAACAGTTTATCCCCCTCTGAGTTCTTATATTTTTCACGGGGGAGCATCGGTTGACTTTACAATTTTTAGACTTCACCTAGCCGGAGTTTCTTCTCTCCTAGGGGCTGTAAACTTTATTAGCACGGTTTTAAATTTACGGGCATTAGGTATGTTGATAGATCGCATACCTTTATTCCCATGGGCAGTATTTATTACTGCTATTCTGGTTCTTTGGTCACCCTGAAGT
ASV279	GGTACAGGATGAACTGTTTATCCTCCTCTGAGTTCTTATATTTTTCACGGGGGAGCATCGGTTGACTTTACAATTTTTAGACTTCACCTAGCCGGAGTTTCTTCTCTCCTAGGGGCTGTAAACTTTATTAGCACGGTTTTAAATTTACGGGCATTAGGTATGTTGATAGATCGCATACCTTTATTCCCATGGGCAGTATTTATTACTGCTATTCTGGTTCTTTGGTCACCCTGAAGT
ASV280	GGAACAGGATGAACTGTTTATCCCCCTCTGAGTTCTTATATTTTTCACGGGGGAGCATCGGTTGACTTTACAATTTTTAGACTTCACCTAGCCGGAGTTTCTTCTCTCCTAGGGGCTGTAAACTTTATTAGCACGGTTTTAAATTTACGGGCATTAGGTATGTTGATAGATCGCATACCTTTATTCCCATGGGCAGTATTTATTACTGCTATTCTGATTCTTTGGTCACCCTGAAGT
ASV281	GGAACAGGATGAACTGTTTATCCCCCTGTGTTATGTCTAGTGCTAAGCCATTTTCCATGGTTTATTGATGGTGCAAATTTAACCTCGGGCGTTTAATCTTGCGCCTAGTTCCCCCCCCACGCCCTGAATTTTGTAGAGTGTCTCGTTGCCCTCCTGTATTATGCATAGGGCCCAGTTTCCCCTAGTGGTTCTTTGGTCACCCTGAAGT
ASV282	GGAACTGGATGAACTGTATACCCCCCATATACCATTTACGTCTAAAGTAGGTCTAATGCTCATTCTCTCATATGGAGTATAATCGGACTCCCCTTCATGCGCACCTATATCAATACTTGCTTTATGTGTTTCCTCAGAAAAAGGAGCCCTTGCCATAGCCGCTCTTTCATCGGAAGTGAGTTCTAAGACGTCGTCGTAGAATCCATCGACTGTGATTTTTTGGTCACCCTGAAGT
ASV283	GGTACAGGATGAACTGTTTACCCTCCTACCGCAGCATTATACTGTAGCCAAGAGTGCAAGACTTTATTCCAATATGTGTAACAACAAGCTAGGGCTAGCCAGGTAGACAGCCATTGGCTATGGCTAGCCTGAGATGTGCAATATGATAAAATGTTCGATAATCATTCCATACAAACTGTGCAATCTTGAAATATATGATTGATTCTTTGGTCACCCTGAAGT
ASV284	GGTACTGGTTGAACTGTATATCCCCCCGACTTGTTTTGAAATGAGGACAACGCTTCGCGCTGATGAGCACAGATTCTCTCGCCAGCGCAAAAGGCTAACGATATTACGCAATGCTTTCCCCCTCATCGCTTGGAAATGAGTAACAAATGGAATCATGAGGCATTTCTGAAGTTTTGAAAGAATGTGCAGCACTCATTGATATGAGGCACCTTATCGCAGGCTCATAGCTTTTGCGAGAGATTTTCTTCTGCTTGTATTTGCATGCAAACATGATTTAAGTAAGGTGCGCTTCGCTGATTCTTTGGTCACCCTGAAGT
ASV285	GGAACTGGTTGAACTGTATACCCTCCTGTCATTAACACTTCCGCCACCTATGTTCTAATAGCTTTATTGGTAACTGCTGGGCTCTTATACAAAAGCTTTGCAGAGAGCGTCAATAAATCACAGTGGTTAAGTTTCAATTGGTTTCAAATTATTAGCAAGGGCTTTGTTGGTATTATTGTGGGACTTCTGTTTATACCTACTTTGTATAACTGGTTTTTTGGTCACCCTGAAGT
ASV286	GGAACTGGTTGAACAGTTTATCCTCCTGCCTACTTGACACTTCTTTCGATGGCACAAGACCAAGGCACATCTTCTCAAAATGCAGACAACGATTTGTCTTTTGACGTCGGAACCGTGGCCGCTGGTGATGTACTCCAGCTGACCTTTAGCTGTGTGTTGGCAGAATCCGTACACGAAAACCTTCTCTCCGTCTCTGGCCTTCTCACGACTGATTCTTTGGTCACCCTGAAGT
ASV287	GGTACTGGTTGAACTGTATATCCTCCGAATAAAAAACCCAATCCTTTTTTAATAACCGATTGACTTTTGTACCCCACGTGGTAGGATGAACACGATTTATTCTAGCGAATAGATCATTTAGGTTACCTAAAACAAACAAACAAACAAACAAGACTACTATGAAAAACAAAATACTAGCTATGCTAGTTGCTTTCGGTCTGGTGGGATCCGTTTCCGCTATCGAAATCAACGAAAACCTCTCCATCAATGGTTTCATCGATGGTTCTTTGGTCACCCTGAAGT
ASV288	GGAACAGGATGAACAGTTTATCCCCCTCCTAATTGGAGTCCTTTTTCTACTCCAGGCTTAGTTTGCCAGTCCATATATGATTGTCCTAATTTGCTCCAATCTGCACTTTTAGAGTTGTAATTTCCAACAACTAAAACAAAATTGGTGTCCCAGTTAACATCTGGTTTTGAAACAAAATTATTGTCAAAATCTACATTTCTGATTTCATCGCTATGATTGCCAGGAAAAGAAGCATATTTTTGACCTATTGCGCCCATTTCTTCAGTAGAGTATTCTGTATCTGATTCTTTGGTCACCCTGAAGT
ASV289	GGAACTGGTTGAACTGTATATCCCCCTTTTAGAATATTAGTAATCCCAAACTATTTAAAATCACAAGACAAGACCAAGGTGATCTGTGCCGATCTCTTGGATTTTGATTGTGACTAAGATTTGGATTTTAAGGAAATTTTTGTGTCCCAAAAGGTTGCGTGATTTTTTTTTGTTTCAAGAGGTTGCATGGTTCTTTGGTCACCCTGAAGT
ASV290	GGAACTGGTTGAACTGTTTATCCTCCGGCCTGCATCGTTGGATTCCTTGCGGGGCGTCGAGCGCGCCATTTTTGAGTTTTGATTGTCTCGAAAGCCTTTTTACCCCTGGCTGGCATCGTTGTATTCCCTGCGGGGCGTCGAGGATCACTTTTTTTGGTTTTTTGTTTGTGGTGAAGCATCCTCTGTCGAATTTGCAGAAAACAAGCGTTTTCCTCCTCTGTTATCATCCCTGTTTAATGATTTGTGTGGTTCTTTGGTCACCCTGAAGT
ASV291	GGTACAGGATGAACAGTATATCCTCCCCAAACAGTGCAGTGCAGTGCAGTGCAGTGCAGTGCAGTGCAGGCAGTGCAGGGCAGTGCAGTGCGGTGCAGGGCAGTGCAGTGCAGTGCAGTGCAGTGCAGTGCAGTGCAGGGCAAGCAGTGCAGTGCAGTGCTCCTCGTGACTCATAGGAGGACATGTGGGGAGGGGCCCATGGCTTCTTACCCACATGAACTACATAGTACTAGAACTAGTGCAGTACTCTGTATACTCTAAAACGTTGGACTTACAGTGTACATGATTTTTTGGTCACCCTGAAGT
ASV292	GGTACAGGTTGAACAGTATACCCCCCTTGGCAGAAATTGAAAAAGAAATACAGTAAAAATTGCACAGAAAAATAATTTTTGGGATGTCAGGATGAAGCCGTATTGCTTGATTTTTACTGACCCTTTCCCTCCTCGCTGGCCGTTTTCTAAAATTTGGTTTCACTGTCATGTCTCTACCTGTAAGGTCTTCAGGATTTGTTTGATTCAATCATCTTTTCAGTTTTGCTTTTTCCATTATCAGTTGTTTGAGCAGGATGTGGTCGTGATTTTTTGGTCACCCTGAAGT
ASV293	GGTACTGGATGAACTGTTTACCCTCCTCTGAGTTCTTATATTTTTCACGGGGGAGCATCGGTTGACTTTACAATTTTTAGACTTCACCTAGCCGGAGTTTCTTCTCTCCTAGGGGCTGTAAACTTTATTAGCACGGTTTTAAATTTACGGGCATTAGGTATGTTGATAGATCGCATACCTTTATTCCCATGGGCAGTATTTATTACTGCTATTCTGGTTTTTTGGTCACCCTGAAGT
ASV294	GGTACTGGATGAACTGTATATCCTCCCTATCCTTGGTTCCTTGCTTCCTTGCTGCCTTGCTTCCGTGCCTCCATGCTGCCTTGCTTCCGTGCCTCCATGCTTCATTGCTTCATCTCTTCCTTGCTTTCTTGCTTCTTTGCTTCATTGCTTCATTACTTCACTGCTTTATTGCTTTATTGCCTCCCTGCTTCATTACTTTATCTCTTCTTTGCTTCCTTGATTTCCTGCTTCCTTGCTTCATTATTGCTTCATTATTGCTTCCTTGATTCTTTGGTCACCCTGAAGT
ASV295	GGAACAGGTTGAACTGTTTATCCCCCTCTGAGTTCTTATATTTTTCACGGGGGAGCATCGGTTGACTTTACAATTTTTAGACTTCACCTAGCCGGAGTTTCTTCTCTCCTAGGGGCTGTAAACTTTATTAGCACGGTTTTAAATTTACGGGCATTAGGTATGTTGATAGATCGCATACCTTTATTCCCATGGGCAGTATTTATTACTGCTATTCTGATTCTTTGGTCACCCTGAAGT
ASV296	GGTACTGGATGAACAGTATATCCTCCTTTTCCCCAATTCCCGTTCTTTGGCTTTCCCCTTTACCCGTTTTTCAACTTGCAGGTTTTCTCCTTTACTATTTTTTCCTAATATTTTTCTTCCCTCCTTTCTTTTTTCCCCTTAACCAATTTTCCTCTTGAGTGTATATCCCTTTTCTGATTTTTTGGTCACCCTGAAGT
ASV297	GGTACTGGATGAACTGTTTACCCCCCAAGATATTGAGTGATTTGTTTGTCCCAAGAGGTTGCTTAATTTTTTTGTCCTTTGAGGTTGCGTGATTTTTTTGTCCCAAGAGGTTGCATGATTTGTTTTTGGTCCCAAAAGGTTGCGGGATTTTTTTTATCCCGAGAGGTTACGTAATCTTTTTGTCCCTAGAACTTGTGTGGTTTTTTGGTCACCCTGAAGT
ASV298	GGAACAGGTTGAACTGTATATCCTCCTTTTTGGCCTCCACGAAGTTTTTCTGCTCCTGCTGGTTTGCAGGCAACTTCATGGACTTCTGGAACTTCTGCCCCAAGGCTGTGCGAATGTTGAACTCGCCTGTCTGTGCTGCCTCTTGCAATTGCTGCACCCAGCTGCATTTGTCTTCGCTGGAGATCCCCAGATCGTTGGTTCTTTGGTCACCCTGAAGT
ASV299	GGTACAGGTTGAACTGTATACCCTCCTCTGAGTTCTTATATTTTTCACGGGGGAGCATCGGTTGACTTTACAATTTTTAGACTTCACCTAGCCGGAGTTTCTTCTCTCCTAGGGGCTGTAAACTTTATTAGCACGGTTTTAAATTTACGGGCATTAGGTATGTTGATAGATCGCATACCTTTATTCCCATGGGCAGTATTTATTACTGCTATTCTGGTTCTTTGGTCACCCTGAAGT
ASV300	GGAACTGGATGAACAGTTTACCCCCCTATTTTGGTAGCTACGTTTAGTAAGACAAAACAAGACCAAGGTGATCTGTGCCGATCTCCTGGATTTTGTTTGTGACAAAGATTGGAATTTTAGGACATTTGTTTGTCCCACAAGGTTGTGTGATTGTTTTTTGTACCAATAGGTTGCGTGATTTTTTTTGTCCCAAGAGGTTGCATGGTTTTTTGGTCACCCTGAAGT
ASV301	GGTACAGGATGAACTGTTTTACCCCCCCTGAATATGGAACTTGTGCTCATACAAGTTAAGTTATGTGATATCTGGGAGTATCTTTAAAACATCCCATTTAGTCAGCTTATTTCCTCTATCTAAGTTTATTAGGCTGGCATGACATTGCTTATTTTCTTTAGCTGTAACCTTTAAATTTTGGTGGTTCTTTGGTCACCCTGAAGT
ASV302	GGTACAGGTTGAACTGTTTACCCCCCTCTTTCAAGAAATATTGCCCATGCTGGTGGCTCTGTGGACTTTGCTATTTTTTCTTTACATCTCGCAGGGGTAAGATCTATTTTAGGTGCTGTTAATTTTATTAGTACTCTAGGTAATCTGCGAGTATTTGGTATATTGCTAGACCAGATACCATTGTTTGCTTGATCCGTACTAGTTACAGCTATTCTTTTACTCCTTTCTTTACCAGTTTTAGCTGGAGCTAATATCAACATCTTTTTTGATTCTTTGGTCACCCTGAAGT
ASV303	GGAACAGGTTGAACAGTATACCCCCCCCGTGTAGAAAATAATAGCGGTCACACGCTAGAAAATAATAGCAGTGTAGAAAATAATAGCGGTGGAAAACTAGAAAATAATAGCAGTATAGAAAACAAGATCATCAGAGAGTGATGGTAGATCCAATGTTACTGATAGTTTAGATTGCCCTGATTCTTTGGTCACCCTGAAGT
ASV304	GGTACTGGATGAACAGTATATCCCCCCGTGAAATGTAATGTCAGTCAATGAGATTTATCAAAATTCCTAGAATAAAAGCATCATGTCATACTGGTCCTTCTTTATCTTGTCTAGTAAAAAATTTCATTTTAAGCATCCATAGTCTTTTTTTTTGGCTTCAATTCTTTCATAGTACTCATATGGTTTTTTGGTCACCCTGAAGT
ASV305	GGTACAGGATGAACTGTATACCCTCCGCGATCACTGATAGCCATTGCCATCTGGATTTCCCAGATTTTGCCGATGAGCTTGACACTATAATAAGCCGAGCGCAGGCCGCGGGCGTTCATCGCATGGTAACGATTTGTACAAAATTACAGAATGAACCCTCTGTACGCGCCATCGCCGCGCGATATGCACCTGTTTCTTACGCGGCTGGCACCCATCCGATGAGCGCAGCAGATGATTTTTTGGTCACCCTGAAGT
ASV306	GGAACTGGTCGAACAGTTTATCCTCCTCCTCTTACAGTACATCTTATATCAAAAGCATTTTCTTTTTTTACTACAGTCAAAGGTCTATAGACTGATAATTGTAAATTAGGTTTTTTAAAATAGTCTATCATTTTTTTACCATTAACATGAATTACTCCAGTACCTACCTTTAACCAAACACGTGCAATTGGTTTTTTGGTCACCCTGAAGT
ASV307	GGTACTGGTTGAACAGTTTATCCCCCGGTCCGAACAAAGCGCCTTCTTCGTCCTCACCTTCTCCGGGAACTCCTGGTCCAAGGGGGCCTTTTCTTTCAGGATCGTCCTCACCTTCCTGCGGTTCCTGTCCGTCTTCTTCTCCACCTGGAGGGCCGTCCTCATCTCCGGGTTTTCTTTCACCTTCCGGATCTTCTTCACCCGCTTTCGGTTCACCTTCTTTTTCCTCACGGGATTTTCCTTCGCCATCTTCAGCTTCCCCGTGGTTCTTTGGTCACCCTGAAGT
ASV308	GGTACTGGTTGAACAGTATACCCTCCCAGGGCCACGTTGTCAAGGTCTATTTCCCTTTGTGCCATTTCGTGTTCGAGCCGCAATTCTCGAATGCGTCGGCTAGTGTATGCTTCGACATAAGGGTCGTCGTCCCACCGTGAGGGTGTTTCCCCTCGTAACTCGCACATACGGTTGCGGGTATATCTCTCTGATTCTTTGGTCACCCTGAAGT
ASV309	GGTACTGGTTGAACAGTTTACCCTCCCAATATGGTTACCTTCTATCTCTGTGGCAGAATTTCCCTATCCTCACAGTCCATCGTCCTACTGATTCTCCATCCCTGTGGCAGAACGTCCTTCTCCTCCCAACCCTCAAGTTTTTTTCACTATCCATCCCTGTGGCAGCTATTGCATGCCTCTCCAATCTATCACTCTTTGAGAGTTTCTTGAATTGCTCTAAATTTCCTGTGATGATGATTTTTTGGTCACCCTGAAGT
ASV310	GGAACTGGTTGAACTGTTTACCCTCCTGAATTTCGATAATTTTGAAAAATTTTACAAGTGTTTTCAACTTTCAAGGGGAAAAAAAATATTTTTTCCCAAAAATGCCCCATTGATCCCAGAAAGTGTTTTAAAGGCATAAAAAGCGAAATGATTCTTTGGTCACCCTGAAAT
ASV311	GGTACAGGTTGAACAGTTTACCCTCCTGTTACATTCTATTTATAGAAACAACCATGCAGTAATCACTACTTTAAAGTAATGGAAACAACAGAGCTTTTACTGGTACTGTAATACACAACTGACTAGTATATTAACCTCTTATCAGTACTCATAGTGGTACTCATAGTGTTACCAATTGTGTGGTTTTTTGGTCACCCTGAAGT
ASV312	GGTACAGGTTGAACAGTTTATCCTCCCTACCAGCTTTATGTGAAGGAATGTCAGCTAATAGCTGATATTCAGGCGTAGCTCTTAGCGTTGGAATTAGGTCAAAAGCTCAAACGGCTTAGATGTTAGGGTAGTTTCAAGTTCTTTTGCCCTGAGGCCCATTCTTTCTAGTAGTTGCAATTTTAGTCCATATATCAAGGTCTGAGCAAGCACCAGGAAGTGTGTTTCACCCCCGTGACGAAAATAACCAAATTGATTTTGATTCTTTGGTCACCCTGAAGT
ASV313	GGTACAGGATGAACTGTTTACCCTCCGGTACGCGCATGATATGTAGTCTGCATATATATCCTTTCGCGCCTTCTGCACTTCCTCTTGTGAAGCTCCGTGGGTGTCATACTGGTAGAATGGTGTCCTGGATCCCACCTAACTGATTGTATCGGGCTTGGTTTTTTGGTCACCCTGAAGT
ASV314	GGAACAGGATGAACTGTATACCCTCCCCTGGATGACAGCCAATTCCCTTGAGCTTATTAAAGAACTGTCACACACGGACACTGAGACGCGCAGAGGAAATGGGGCGAGGTAGAGGATTATCTTATTTACAAGATTGAGATGTTTTGCAAATTAATTGTGAGAGTTTTATACAGGAAATTAAGTTTATGGTTCTTTGGTCACCCTGAAGT
ASV315	GGTACTGGTTGAACAGTATACCCCCCACTATCAAGCATCTAATTCCATAAAGGAATCAGGGTCGATTGTACTATTTTTAGTTTGTCTAAAATTAGCTTTGTACAAATACCTTTATTTGTAGGGTCTTTATTAATTACAACAAGGCAGTTATTATTAGCTTTACCTGTTTTAGCAGGGGCTATAACTATGTTAATATGGGATCTAAATTTAAACACTTCTTTTTTTGATCCTAGAGGAGGTGGGGGTCCTATTTTATACCAGTACCTATTTTGGTTTTTTGGTCACCCTGAAGT
ASV316	GGAACTGGTTGAACTGTTTATCCCCCTCTGAGTTCTTATATTTTTCACGGGGGAGCATCGGTTGACTTTACAATTTTTAGACTTCACCTAGCCGGAGTTTCTTCTCTCCTAGGGGCTGTAAACTTTATTAGCACGGTTTTAAATTTACGGGCATTAGGTATGTTGATAGATCGCATACCTTTATTCCCATGGGCAGTATTTATTACTGCTATTCTGGTTCTTTGGTCACCCTGAAGT
ASV317	GGAACTGGTTGAACTGTATATCCTCCTCTGAGTTCTTATATTTTTCACGGGGGAGCATCGGTTGACTTTACAATTTTTAGACTTCACCTAGCCGGAGTTTCTTCTCTCCTAGGGGCTGTAAACTTTATTAGCACGGTTTTAAATTTACGGGCATTAGGTATGTTGATAGATCGCATACCTTTATTCCCATGGGCAGTATTTATTACTGCTATTCTGATTCTTTGGTCACCCTGAAGT
ASV318	GGAACTGGTTGAACTGTATACCCTCCACATGCGACAGTTTACTCTCCACATGCGACAGTTTAGCCTCCACATGCGGCAGTTTACCCTCCACATGCGACAGTTTACCCTCTACATGCGACAGTCTACCCTCTACATGCCTCGCAACACCATCCCGCACCATCTCGCACCATCTCGCACCATCTCGCAACACCATCTCCTCGCACACCATCCCGCCCCTCGCCTGCTGCCATTTACACATGTGTATACATGCGCATGGACGCTATGATTCTTTGGTCACCCTGAAGT
ASV319	GGAACAGGATGAACTGTTTATCCCCCAGCCTACGGAAATCTTCCTACAACCTCCAATTCTTCTTCAAAGTTAAAATAAAAGACAATGTAAAAAGATGTAAAAAGATAATGTAAAAATACCGGGCTTTTGTGCCATTGAGTGGACTTTTAGGCATAATCTAAATAAAAAAAACATAAGTTTTGAAGTATAAGAAGAGCAAAACTACAATATGGTGGTTTTTTGGTCACCCTGAAGT
ASV320	GGTACTGGTTGAACTGTTTATCCTCCAACTCTTGCGCAACAAGGCAAAGTGGCAAATAGCCCGCACCAACGCCGCCAAAGGCTTCCGGGATCGCGGTGCCTTGCAGCCCAAGCTCCGCCAAACCCTGCCAGACATCGCTGGCCTGCAGGGATTCCCCTTCCATGATCGATCGATGTCGGCTCAAGGGGCTCTTCTCGCTCAAAAATCTGCGAACCTGTTCTTGGATCATTCGATCCTCGCTAGAAAAATCAAAATTCATCGGTGTTTTTATTCCTCGTCAATTGTTTTACTGGTTCTTTGGTCACCCTGAAGT
ASV321	GGAACTGGTTGAACAGTTTATCCCCCATTTGAAAACTTCACAACCCGTACTGCCATACTGTTCTCTTACAAACTTTCTTAAAAGTATGAGTTTAGCGGCTGAAATGGGGAAACAGACATCTATTTAGAGGCTAGGGCAGAAATCCTTACAAAAATTTCGTTGGTTCTTTGGTCACCCTGAAGT
ASV322	GGAACTGGTTGAACTGTATACCCCCCTATCCTCATCCTGAACACGGAGATCTTTTCCCCTCTGTTAGTTTCCATCATCATGATTGTACCTTTCCGCTCCGGTTATATCTGCGCAGGTGATAGCTGTCATCCTCATTGAAGTATCTTGAAAAGACTTGACTGGCTTGTGACAAACTGGTCCAGCCCCCTTGTTCCTGATTTTTTGGTCACCCTGAAGT
ASV323	GGTACAGGTTGAACAGTATACCCCCCTGCTTTGTTGTCCAGCCTCCCCAGGAACTTGTCTCTTTATATTCTCTTGGCCAACCTACAGTCGGCGAATATAATATTGGTGCACCCAAAAAACGCAATAATTTTTGGTGCTTTCAAATTCTCCATTTTTCCAATATTGCAATAGCAATATTGGACTTTCTCTATTGCTCCCCATATAGTTATCGCTCTTCCAACTTTGCGATAGCAATAGTTGTCGCTCTTAATGTTGTTTTGCTTCATTTTTTTATTTTGGTCATTGCTTCATTTTTTGTGTTGGTTTTTTGGTCACCCTGAAGT
ASV324	GGTACTGGTTGAACTGTTTATCCCCCTCTTTCAAGAAATATTGCCCATGCTGGTGGCTCTGTGGACTTTGCTATTTTTTCTTTACATCTCGCAGGGGTAAGATCTATTTTAGGTGCTGTTAATTTTATTAGTACTCTAGGTAATCTGCGAGTATTTGGTATATTGCTAGACCAGATACCATTGTTTGCTTGATCCGTACTAGTTACAGCTATTCTTTTACTCCTTTCTTTACCAGTTTTAGCTGGAGCTAATATCAACATCTTTTTTGATTCTTTGGTCACCCTGAAGT
ASV325	GGTACTGGATGAACTGTTTACCCTCCTCTTTCAAGAAATATTGCCCATGCTGGTGGCTCTGTGGACTTTGCTATTTTTTCTTTACATCTCGCAGGGGTAAGATCTATTTTAGGTGCTGTTAATTTTATTAGTACTCTAGGTAATCTGCGAGTATTTGGTATATTGCTAGACCAGATACCATTGTTTGCTTGATCCGTACTAGTTACAGCTATTCTTTTACTCCTTTCTTTACCAGTTTTAGCTGGAGCTAATATCAACATCTTTTTTGATTCTTTGGTCACCCTGAAGT
ASV326	GGTACAGGATGAACTGTATATCCCCCTCTTTCAAGAAATATTGCCCATGCTGGTGGCTCTGTGGACTTTGCTATTTTTTCTTTACATCTCGCAGGGGTAAGATCTATTTTAGGTGCTGTTAATTTTATTAGTACTCTAGGTAATCTGCGAGTATTTGGTATATTGCTAGACCAGATACCATTGTTTGCTTGATCCGTACTAGTTACAGCTATTCTTTTACTCCTTTCTTTACCAGTTTTAGCTGGAGCTAATATCAACATCTTTTTTGATTTTTTGGTCACCCTGAAGT
ASV327	GGTACAGGATGAACAGTATACCCTCCTAACTATGCGCCTATTTAAGACTTGCTTTCGCTTCGGCTACGGACCTGAAGCCCTTAACCTTGCTAGAGAGGAGTAACTCGTAGGATCATTATGCAAAAGGCACGCCGTCGCCCGAAGGCTTCGACCGCTTGTAGACAGTAGGTTTCAGGTACTATTTCACTCCCTTTTTCAGGGTACTTTTCACCTTTCCCTCACGGTACTTGTTCACTATCGGTCTCTCAACATATTTAGCCTTACCAGATGATTCTTTGGTCACCCTGAAGT
ASV328	GGAACAGGTTGAACTGTTTATCCTCCCCGAAAAAAATAGTTTTTTTTTAGAAACAAATGAAAAGGAGAAGGGCCCCTATCGGTGGTAGATGGGGGTCCTCGCTCTCGTGTCTGCGCATGCTTAGCCCCTCATCGACGTGAACAGAAATTTAATCACAAGCTTGGAGAACTAGTTCAGACTTGTATGATCTGCTTGTTTAATCTTGATTTTTTGGTCACCCTGAAGT
ASV329	GGTACTGGTTGAACAGTTTATCCTCCCTCTCTACTGTGAGCACCTTAGGTTATTTTTTTCCGCTATGTTTTTTTGGATTATTGGGGTTATTTGGTACGTGGTGAAACAGATTTTGTAAAATCGAGGGTTGAATTTGATAAAAACAATGTGAAAGAAGGATTGCCAAAATTTGACATAATAAAGGTGAGAGGGTTGATGTTGATGGTTTTTTGGTCACCCTGAAGT
ASV330	GGAACAGGTTGAACTGTTTATCCCCCATAAAAATGCCTACAGTTAAGAAACATTTTTTGTTACTTTATGCCTTTGCAATTCAAGCAAAGATTACCCTCTAAAACCCTTAAATCAAGGTCTGAGCAAGCACCAGGAAGTGAGTTCCACCCCCATGACGAAAGTGAAAAAATCGATTGTGGTTTTTTGGTCACCCTGAAGT
ASV331	GGAACTGGTTGAACAGTATATCCCCCTCTGAGTTCTTATATTTTTCACGGGGGAGCATCGGTTGACTTTACAATTTTTAGACTTCACCTAGCCGGAGTTTCTTCTCTCCTAGGGGCTGTAAACTTTATTAGCACGGTTTTAAATTTACGGGCATTAGGTATGTTGATAGATCGCATACCTTTATTCCCATGGGCAGTATTTATTACTGCTATTCTGATTTTTTGGTCACCCTGAAGT
ASV332	GGAACTGGTTGAACTGTATACCCCCCTCTGAGTTCTTATATTTTTCACGGGGGAGCATCGGTTGACTTTACAATTTTTAGACTTCACCTAGCCGGAGTTTCTTCTCTCCTAGGGGCTGTAAACTTTATTAGCACGGTTTTAAATTTACGGGCATTAGGTATGTTGATAGATCGCATACCTTTATTCCCATGGGCAGTATTTATTACTGCTATTCTGGTTCTTTGGTCACCCTGAAGT
ASV333	GGTACTGGTTGAACTGTTTATCCCCCTCTTTCAAGAAATATTGCCCATGCTGGTGGCTCTGTGGACTTTGCCATTTTTTCTTTACACCTCGCAGGGGTAAGATCTATTTTAGGTGCTGTTAATTTTATTAGTACTCTAGGTAATCTGCGAGTATTTGGTATATTGCTAGACCAGATACCATTGTTTGCTTGATCCGTGCTAGTAACAGGTGGGGACCCTATCTTATACCAACATCTTTTTTGGTTTTTTGGTCACCCTGAAGT
ASV334	GGTACTGGTTGAACTGTATATCCTCCAAGCGGATACCTTCGAGTAGCGTACCGCTCTCGTTGACTTGGGGTCTGCCATAGGTCAGGGTTGAATCCATATGGAAATGACTGTCGACGAAAGGCGGACTGACAAGGTAGCCTTTGGCGTCAATCTCGACCTCGGCCTGGCTATCAATATGCGCAGCGCGTTCGACGATGCGGCCTTTGCGACAGGCGATATCCTAAAGTGCCGGCTCATCAGGGGTTCTCGCGTTTCTTACAATCAGATCTAACATAATTTTGGTTCGATTTATGGTTCTTTGGTCACCCTGAAGT
ASV335	GGAACAGGTTGGACTGTTTACCCTCCCAACAAGTCTGCTGCTTCTGCGATCTTGCTGCGAGAACTCTTCCTTCGTTCTTCTCGTTCTTTTACTGCCTTCTGATAGGCAGTCATCTGTCGAGCATTGACCTCGGGTTTGGTCTGTTCAACCACCGGAGGAACATATCCCTCGACTGCCTTATCGTCGAAGGATCCCTTAGCGGATGTCGAATCGACTTTAGTTGCCGTGACATAAGACTCCATACTACCAGAAAGATTTTGTTTCTCTTCCTTAATTACTGATTCTTTGGTCACCCTGAAGT
ASV336	GGTACTGGATGAACTGTTTACCCTCCAACTCTTGCGCAACAAGGCAAAGTGGCAAATAGCCCGCACCAACGCCGCCAAAGGCTTCCGGGATCGCGGTACCTTGCAGCCCAAGCTCCGCCAAACCCTGCCAGACATCGCTGGCCTGCAGGGATTCTCCTTCCATGATCGATCGATGTCGGCTCAAGGGGCTCTGCTCGCTCAAAAATCTGCGAACCTGTTCTTGGATCATTCGATCCTCGCTAGAAAAATCAAAATTCATCGGTGTCTTTATTCCTCGTCAGTTGTTTTACTGGTTCTTTGGTCACCCTGAAGT
ASV337	GGTACTGGATGAACAGTTTATCCCCCTCTTTCAAGAAATATTGCCCATGCTGGTGGCTCTGTGGACTTTGCTATTTTTTCTTTACATCTCGCAGGGGTAAGATCTATTTTAGGTGCTGTTAATTTTATTAGTACTCTAGGTAATCTGCGAGTATTTGGTATATTGCTAGACCAGATACCATTGTTTGCTTGATCCGTACTAGTTACAGCTATTCTTTTACTCCTTTCTTTACCAGTTTTAGCTGGAGCTAATATCAACATCTTTTTTGATTCTTTGGTCACCCTGAAGT
ASV338	GGTACTGGTTGAACAGTTTATCCTCCTCTTTCAAGAAATATTGCCCATGCTGGTGGCTCTGTGGACTTTGCTATTTTTTCTTTACATCTCGCAGGGGTAAGATCTATTTTAGGTGCTGTTAATTTTATTAGTACTCTAGGTAATCTGCGAGTATTTGGTATATTGCTAGACCAGATACCATTGTTTGCTTGATCCGTACTAGTTACAGCTATTCTTTTACTCCTTTCTTTACCAGTTTTAGCTGGAGCTAATATCAACATCTTTTTTGATTTTTTGGTCACCCTGAAGT
ASV339	GGTACTGGTTGAACTGTTTACCCTCCCAAAAAACATTTTTGCTCCCTGTCTAATACCTACTTCAGTATTTATGAAAAAACTTTTAAATTCATTGTACTTAGCGATAACTAATAATACAGGCCTGCCATAATATTTGTCTGTCATTCTTTTTTAGGCTCTTCATTTTTATTATCTTCTGGTTTTTTGGTCACCCTGAAGT
ASV340	GGAACTGGTTGAACAGTATACCCTCCGGTCACTCATTACATCTACATCTAACCAATTAATGCCAGCATCACTTAAATCATTTACACTTACCCAATTAATCCCCGCATCACTCATGACGTCCATATCAAGCCAATTAATACCCCGGTCCCTCATTACATCTACATCCATCCAATTAATGCCCGCATCACTTAGGTCATTTACACTTACCCAATTTACTCCCGCATCACTTAACACATCAACATCCGTCCAGTTAATACCCGTGTCACTCAATACATCTAGATCCGTCCAATTGATTCTTTGGTCACCCTGAAGT
ASV341	GGAACAGGTTGAACTGTTTATCCTCCAGTTTTTGTCTTAAAAAAGGTTCTCACCACTTCGTTGGGAATTTTCGACGGGTTGTTTGGCGGGTTTAAGAACCGAATCTACTCGCCCAAGTTCCGGCTTTTCTTCGTGGCCAAGTCGCTGGGGAGTGTTAGGGTGTTTTCCTGAACTTTTTTGTCTCGTCGCGGGTGTTTGGTCGTTTTGATTCTTTGGTCACCCTGAAGT
ASV342	GGTACTGGTTGAACTGTTTATCCCCCGCCAGAAGCATTGATGTTCAGATCGTATTTATCTCTAAGGTTTAATACTTCCAAAGGTTTCATAGCGTGAATAACTAAAGATTCTCTTTTTAGATGTGAATCAATATTTAATTTTTTATTAACAGTAGAAGTTCCAGAACCGTCAGATAGATAAACTCTTGCAGTTGATTCTTTGGTCACCCTGAAGT
ASV343	GGTACTGGTTGAACAGTTTACCCCCCATCAGCTGCTTCCCCAGTCCAATGTGGGTGCTAGTACAGTGGTTGCGGTGGTATCATGGCTAGAAGCCACGTTGGCTCGGGTGGCTCGGTGGTGCCCGTACAAGAGATAGGAGGCATTGAGCGAAAAAATCATTGGCGATAAGGTTCGTGGTAACAACGTTTGGGAACAAAAATTCACACTTTTGGAGACCTTGTAAAAAATGAGAAAAATCATCGAAAAACAGGAGCCTGCTTGAGGCTGCTGGATTTTTTGTGATTTTTTGGTCACCCTGAAGT
ASV344	GGTACAGGTTGAACTGTTTACCCCCCGGAGGTCACGGCCTTGGGCCGTCAACTCAACTCTTGTCTTTTCCCTGATCTCCGAAATATTCATCCTGCTACTTTCTAATTAATCGCGCTCTGCGAACCGGCAGCGAACCGGCATCTTGGCCGCCGCTGAACTCAACGCCTCGCGTGCAACGCTTTCTGGCACGCCCTCTACCTCAAATAACATTGTGGCCGGCCTGACCACGGCCACCCAGTGATCCACGTTGGCCTTGCCCTTGCCCATCCGCACTTCCAATGATTTTTTGGTCACCCTGAAGT
ASV345	GGAACAGGATGAACAGTATATCCCCCACCCCTAAATCGGAAGCTGCGGGGATCATATACTGGGAGAACCAATGGAGGGGTTAGGAACGTTTTACTGGAAGGTTCGATTACCCGATAGACGGTGGTTTTTAATGGTTTTTAGTGGTTTTTAGTAGTTTTCTAGTGGTTTTTAGTGGTTTGTTAGTGGTTTTTAGTGGTTTGTTAATGGTTCTTTGGTCACCCTGAAGT
ASV346	GGTACTGGTTGAACTGTATACCCCCCCTTCTCCATATTTCTAGAGTGGGAAATTGTAGGGGGAGGGGGTAGTTTGATTTGCATAAGCTGAATGCTCTTAAAGTTGAGCAGACCGCAGGGGCGTAGCCAGGATTTTTTCAGGGGGGGCACAGCCTTTTTAGCTGGGATTGGTTTTTTGGTCACCCTGAAGT
ASV347	GGTACAGGTTGAACAGTATACCCCCCCATGTGAAAAAAACTGTGGTCCCCACTTACTTTTTTGTACTTTTGAGTATTTTTTGGTACTTTTGGGTACTTTAGTGTACTTATGAATAATTTTGAGTATTTTCTGTACTTTTGAGTACTTTTGGGTACTTTTTTGGTCATTTTGAGTATTTTTGGCTGATTCTTTGGTCACCCTGAAGT
ASV348	GGAACTGGTTGAACTGTATATCCCCCTTTTTTAATATACACGTGTAAGGTATACTGGCCATCCTGGCTCGTTACCCTCGCTGAAGGATGTCCTATAAAAATTCCTTATCGACGTTTTTAGTTTAAAGGCCACCCTGAAAAAAGGTTGATTTTTCGTTCCCATCAATATGTTCAATCTTTGATTCTTTGGTCACCCTGAAGT
ASV349	GGTACTGGTTGAACTGTTTACCCTCCCCTTTCTAGAAATATTGCACATGCAGGAGGATCTGTAGATTTTGCAATTTTTTCTCTTCATCTGGCAGGTGTCAGATCTATTTTAGGTGCTGTAAATTTTATTAGCACTTTAGGTAACTTACGAGTATTTGGTATATTATTGGACCGGGTACCATTGTTTGCCTGGTCGGTATTAATCACCGCAGTTCTTCTGCTATTATCTTTACCGGTATTGGCAGGAGGTGGAGATCCCATTTTATATCAACACTTATTTTGATTCTTTGGTCACCCTGAAGT
ASV350	GGTACAGGTTGAACTGTTTACCCTCCACCCCATAAAGCAGAGACTCCCCTCCACAAGTACAATCACACCTGGTAGTCTGAAGGCAAGGACCAAGAGCAGGCTGAGCTTGGAGACTGGGCACATCTTGGAGGCTGCTGAGTGCAAATCTGTGATTTTTTATGATTTTTTGGTCACCCTGAAGT
ASV351	GGTACAGGATGAACAGTTTATCCTCCCTGTCTCACGGCTTTCTCACTCCCTCGGCTGAACCCCCCCCCTATCGGGGCGTAATATGATATTTGAACAGCCCCTTACCACCATTGGGATGATAATGTGAAGGATTATGTATTACGTTGCCATTTTTGTCTTTTTCTAATGGTTTTTTGGTCACCCTGAAGT
ASV352	GGTACAGGTTGAACTGTTTATCCCCCGAATAAATATGCAACTTTGACCAAATAAACTCACATCTACCACTTGCTGATAAAACCCTGGCTGGGAGACCTCCTAGTAGGCAAATAAGGAGACCTCCAGGCCATGTTTTTATCTGAAAGTGGTAGAGGCGAGTTAAAATGTCTTCAATTTGGTTCTTTGGTCACCCTGAAGT
ASV353	GGTACAGGTTGAACTGTTTACCCTCCCCCCTTTGGACATTGCCCGAAAAAAAGACGTTTTTTTCTAATGCGTTCCCTTAGCGACCGAATTACTTAATGGATAAAGAGGTTTGCAAAACAGCCCCTCTCTCTGCTGGGTCTGCCTTTCATTTGTAAATACTAAACAGGTAACTTTTTCTTCTTTTTTTCATCTTGTGATTCTTTGGTCACCCTGAAGT
ASV354	GGAACTGGTTGAACTGTTTATCCCCCTCTGAGTTCTTATATTTTTCACGGGGGAGCATCGGTTGACTTTACAATTTTTAGACTTCACCTAGCCGGAGTTTCTTCTCTCCTAGGGGCTGTAAACTTTATTAGCACGGTTTTAAATTTACGGGCATTAGGTATGTTGATAGATCGCATACCTTTATTCCCATGGGCAGTATTTATTACTGCTATTCTGGTTTTTTGGTCACCCTGAAGT
ASV355	GGAACTGGTTGAACAGTTTACCCCCCTCTGAGTTCTTATATTTTTCACGGGGGAGCATCGGTTGACTTTACAATTTTTAGACTTCACCTAGCCGGAGTTTCTTCTCTCCTAGGGGCTGTAAACTTTATTAGCACGGTTTTAAATTTACGGGCATTAGGTATGTTGATAGATCGCATACCTTTATTCCCATGGGCAGTATTTATTACTGCTATTCTGGTTTTTTGGTCACCCTGAAGT
ASV356	GGTACTGGTTGAACTGTATACCCCCCTCTGAGTTCTTATATTTTTCACGGGGGAGCATCGGTTGACTTTACAATTTTTAGACTTCACCTAGCCGGAGTTTCTTCTCTCCTAGGGGCTGTAAACTTTATTAGCACGGTTTTAAATTTACGGGCATTAGGTATGTTGATAGATCGCATACCTTTATTCCCATGGGCAGTATTTATTACTGCTATTCTGATTTTTTGGTCACCCTGAAGT
ASV357	GGAACTGGTTGAACAGTTTATCCCCCATTATCCCAAATTTTCAAATGGTGTGTTCTACCTTCGACAATCCAAGTTATTGTTTCATTAGAATTCGCCTCCATGATTCCATCCAACAACTCATCCCGATCAGGTGCTTCAAATTGATATGTGTCTCCAAGGTTGTTAGTAAGTACTCCTTTACTTGGTTCTTTGGTCACCCTGAAGT
ASV358	GGAACAGGATGAACAGTTTATCCCCCTCTGAGTTCTTATATTTTTCACGGGGGAGCATCGGTTGACTTTACAATTTTTAGACTTCACCTAGCCGGAGTTTCTTCTCTCCTAGGGGCTGTAAACTTTATTAGCACGGTTTTAAATTTACGGGCATTAGGTATGTTGATAGATCGCATACCTTTATTCCCATGGGCAGTATTTATTACTGCTATTCTGGTTCTTTGGTCACCCTGAAGT
ASV359	GGTACAGGATGAACAGTATATCCCCCAAATAGTTCCCAAATGTATTGATATACACGCTGATTGTGTTAACACTAATGTAATTTCAATTTGCCGCTCCAGCCAGTCTGCTGCGTCCCAATTAAAGGGGTGAGTAATGATCTTTCAGCCCCCAGCCAACTTTCAATCCTCCTCAAACCCCATTTTATCTTTCATAAATTCATCTTCAATATTCAAGTATAGAGAGGAAACTTTTTGGTTCTTTGGTCACCCTGAAGT
ASV360	GGTACAGGATGAACTGTATACCCTCCCCCCTTTTTTCGTCAAAAGACTAATCATAGATATATGGATAGATCTTTGTAAAATGACAGCAATCCTCTCTCATTTGCCTTTATCTATTTCCCCCCTACTTATAATAACTGAGTGACATATACTCAATAAGATTAGTATACGAGCCCACCTGGACATGGTTCTTTGGTCACCCTGAAGT
ASV361	GGTACTGGTTGAACTGTATATCCCCCACAACATGTCATAATTCATGTGTCATATGTCACGTGTCACATGTAAAGTGTCACCTATCACATGTCTCGTTTCACATGTCATGTGTCACATGTCACATTTTATTTTATCTTTTTTTAAATATCTTTTTGTACAAGGTGGTGAAGCTTATTGGTGGAGGGTCTGTTATCAATGGGGCCTACCCTGTCTAGTTTCTTGATTCTTTGGTCACCCTGAAGT
ASV362	GGTACTGGATGAACTGTTTATCCTCCAGAAACATTTTTGACACAAAATCAAAAAAGTGCAACTCAACCAAAAAAAAATCTAGATAAGATTTTTTTTGCACGAAATTGAAACTTGAAAAAATAAATCACCAACCGAAACTGAAAACACTGAATTAAAAGTTTTTTGGAGTAGAGCACATTTTGGTCCAAAATCAAAACATTTTCAAATTGGTTCTTTGGTCACCCTGAAGT
ASV363	GGAACAGGATGAACTGTATATCCTCCTCCTCTCGCTAGTCTCTGTCGTCTTCACCAAGGTCTCCCTTGTCCATCCTCCCTCCTGTCCTACTCTGATACTCTGTCCTCCTCTGATACTCTGTCCTCCTCTGATACTCTGTCCTTCTCTGATAATCTTGACCTCCTCTGATACTCTCTCCTGCTCTGATTCTTTGGTCACCCTGAAGT
ASV364	GGAACAGGATGAACAGTATATCCCCCCGTGAAATGTAATGTCAGTCAATGAGATTTATCAAAATTCCTAGAATAAAAGCATCATGTCATACTGGTCCTTCTTTATCTTGTCTAGTAAAAAATTTCATTTTAAGCATCTATAGTCTTTTTTTTTTGGCTTCAATTCTTTCATAGTACTCATATGATTCTTTGGTCACCCTGAAGT
ASV365	GGAACTGGTTGAACAGTTTATCCTCCATTAAGCACTTCTTTCATGAGTTTATCACCTTCAACTACAGCTTATCTTATCTTTGGATTATTAATGTCAGGTATATCCTCATGTCTAACTTCTATTAACTTTTTTATTACAATTCTTAATCTGAGATCTTATTATCTTACATTAAAGACTATGCCATTATTCCCATGGTCTCTTTTGATAACAGGAGGAATGCTATTATTAACGTTACCAATCTTATCAGGTGCATTACTAATGGTCTTTATTTTGGTTCTTTGGTCACCCTGAAGT
ASV366	GGAACAGGTTGAACTGTTTATCCCCCCCCAAGAACTCAAAATTGCTTTTTTAGGCGCGCGACACCACCAAATGGCTCTTTTTACCCCCAAGGACTCAAAAATATTGTTTTAGGCGCACGACGCCACCAAAGGGCTCTTTTTACACCCCAAGGACTCAAAAAAATTTTGGGCGCGCGGCGTCACCAAGGCCTCAAAATTTCTTTTTTAGGCGCGCGGTGCCACCAAAGCGCTATTTTTACCTCCCCAAGGCCTGAAAATTGATTTTTTAGTCACCCTGAAGT
ASV367	GGTACAGGTTGAACAGTTTATCCCCCTGTATATCCAACAGAAGTGGAAGTAACCCCTTTCACCTTACCAAAGGCCACTTCGATACCCCAGAAACATCCTGCCCCGAAAATTGCGGTTGCCATAATCCCTCCTAATTAACCTCGACTGGTGATCTCAATCAGATGATAACCAAATTGATTCTTTGGTCACCCTGAAGT
ASV368	GGTACAGGATGAACTGTTTATCCTCCCTCAAAATATAACCCTTTTAACAAAAATTTCAAAAAGTTTAGATGTCCCAACACTTCTTCTTAAAGGTACCGTGACGCAAAATATTTTTCCTTAAAAAGTGGTACACAGGGTTGTTAAGATCTCGGAAATGATTATGATTTACAAAAATAATTAGAAAAGAATACAACACAATTGAATTTGATGGTTCTTTGGTCACCCTGAAGT
ASV369	GGAACTGGATGAACTGTATATCCTCCAACACTTTATAAAGTTATTATTGGAGTATCTTTAAAACATCCCATTTAGTCAGCTTAATTCCTCTAGCTAAATTTTCTAAGCAGGTTTTGTATTGCTTAATTTCTTTAGCTGTAAACATTTTATTTTGGTGGTTCTTTGGTCACCCTGAAGT
ASV370	GGAACAGGTTGAACTGTTTATCCTCCAGAATTTGAGATTCTAATGGAGTTGGATTTAAATGTTTTCAATTGGTTTTAGTTTTAAGTTTTATGGTTTTTATTTTTCATGTGTTGACGATGGGAACTTTCCTCTTGCTTATTGAGGTGAAAATGTTCTTGGTTCTTTGGTCACCCTGAAGT
ASV371	GGTACAGGTTGAACAGTTTACCCTCCCAGAGCCTGACGTGCCTCAACGTGAGTCAGCAGGACATGGTATGCCGAGGAGGGGCTTGCAGAAGGCAGAAGGGCCAGACACATGTGCGGTCATGCTTGCTCAGCCCCTATAGCTGAGCTGTCTCGGCCCTCCAAGCCTCCCTGCCCCTCTCAGCATACGCATGCTGATTCTTTGGTCACCCTCAAGT
ASV372	GGTACTGGTTGAACAGTATATCCCCCCCTTTCTAGAAATATTGCACATGCAGGAGGATCTGTAGATTTTGCAATTTTTTCTCTTCATTTGGCAGGTGTCAGATCTATTTTAGGTGCTGTAAATTTTATTAGCACTTTAGGTAACTTACGAGTATTTGGTATATTATTGGACCGGGTACCATTGTTTGCCTGGTCGGTATTAATCACCGCAGTTCTTCTGCTATTATCTTTACCGGTATTGGCAGGAGGTGGAGATCCCATTTTATATCAACACTTATTTTGATTCTTTGGTCACCCTGAAGT
ASV373	GGTACTGGTTGAACTGTTTACCCCCCGTTCTTTTATTCTTTTGTCCTCTTGTCCTTTTGTTCTTTTGTCCTTTTGTCCTTATGTTCTTTTTTCACATTTGTCATTTTGTCCTTGTGTTCTTTAGTCCTTTTGTTCTTTTATCCTCTTTTCTGTTGTCTTTTTGTCCTTTTGTCCTTTTATTCTTCAGTTTGTTTGACCCTTTGTCCTTTTTTCCATTTGTCCTTTTTTAATTTTGTCCTTGGGCCCTATGATCCTTTGATCCTTCAATCCTTTGGTCCTTTGATTTTTTGGTCACCCTGAAGT
ASV374	GGTACAGGTTGAACTGTTTACCCCCCGGAATTTACAAAGTAAGTCTTTTGTGAAAGGTTATAGGGTGCCTTAAACACCCATAATTTTCCTCATCTGTATCGGGTGCCATTTAGGTAAAAAAAAATCACTAAAAAACAAATTATAACTTTTAATGGTTCTTTGGTCACCCTGAAGT
ASV375	GGTACAGGATGAACTGTATACCCCCCTCGCTCATCGGGCGATGAATACGTGTATGTATTCAAAGACCTCTCAAGAGTGATTATGTGTATGTGTTCAATTTATTGTATCCTACCAAAGAGTATATTTGCCCTTTTTTTATTGAATTCATTATTTATTTGTCTCAAATATTCATTGTATGTACTCTATAGCAAGATACTTGTCCTTAGGTCCAAAAGGTCCGTCCCTGGGTCCATTGATCCATATAAGTTCTTTGATTCCTTGATTCTTTGGTCACCCTGAAGT
ASV376	GGAACTGGATGAACTGTTTATCCTCCCCTACTTAAGGACTAATTTAGACGCAATTTGTTCCAAGAGGTTGCATGATTTTTTGTCTCAGAGGTTGCGTGATATTTTTGTCCCAAGAGGTTGCGTGATTTTTTTTCTATCCTCAGAGGTTGCGTGATTTTTTTGTCCTAAGAGGTTGTGTGATTCTTTGGTCACCCTGAAGT
ASV377	GGTACTGGTTGAACAGTTTATCCCCCCCTTTCTAGAAATATTGCACATGCAGGAGGATCTGTAGATTTTGCAATTTTTTCTCTTCATTTGGCAGGTGTCAGATCTATTTTAGGTGCTGTAAATTTTATTAGCACTTTAGGTAACTTACGAGTATTTGGTATATTATTGGACCGGGTACCATTGTTAAATACAACTTTTTATGATGTAGGTGGAGGTGGAGATCCTATTTTATACCAACATTTATTTTGGTTTTTTGGTCACCCTGAAGT
ASV378	GGTACTGGTTGAACTGTATACCCCCCTCTGAGTTCTTATATTTTTCACGGGGGAGCATCGGTTGACTTTACAATTTTTAGACTTCACCTAGCCGGAGTTTCTTCTCTCCTAGGGGCTGTAAACTTTATTAGCACGGTTTTAAATTTACGGGCATTAGGTATGTTGATAGATCGCATACCTTTATTCCCATGGGCAGTATTTATTACTGCTATTCTGGTTTTTTGGTCACCCTGAAGT
ASV379	GGTACAGGTTGAACAGTATATCCTCCTCTGAGTTCTTATATTTTTCACGGGGGAGCATCGGTTGACTTTACAATTTTTAGACTTCACCTAGCCGGAGTTTCTTCTCTCCTAGGGGCTGTAAACTTTATTAGCACGGTTTTAAATTTACGGGCATTAGGTATGTTGATAGATCGCATACCTTTATTCCCATGGGCAGTATTTATTACTGCTATTCTGATTTTTTGGTCACCCTGAAGT
ASV380	GGTACTGGTTGAACTGTATATCCCCCTCTGAGTTCTTATATTTTTCACGGGGGAGCATCGGTTGACTTTACAATTTTTAGACTTCACCTAGCCGGAGTTTCTTCTCTCCTAGGGGCTGTAAACTTTATTAGCACGGTTTTAAATTTACGGGCATTAGGTATGTTGATAGATCGCATACCTTTATTCCCATGGGCAGTATTTATTACTGCTATTCTGATTTTTTGGTCACCCTGAAGT
ASV381	GGTACAGGTTGAACTGTTTACCCTCCAATTTTATATTTAGGATATGTTGGTTCATCGATAATTTTTTCTTCAGCTCTTTCAGCCACAACACTTAATTATATTTCAAAAGAGTGGGCCAAGCATCTTAAGCAGTGGGTTTTAGTATCATGGATTTTTTTGACTTTAGGGATTTTACTTGGTTCTATTTGGGCCTATTATGAATTGGGTTGGGGTGGTTCTTTGGTCACCCTGAAGT
ASV382	GGTACAGGTTGAACAGTATATCCCCCCTTATCCCTTCATGTCCATATATTTGTTCTGTATGTCTGTGTCTCTATTTCTGCTTTGCAAATAGATTCGTCTGTGCCATTTTTCTAGATTCCACATCAGTTCAGTTCAGTCACTCAGTCACGTCTGATTCTTTGGTCACCCTGAAGT
ASV383	GGAACAGGATGAACTGTATACCCTCCAATAAAATCCATGCGTTTGGTCACAGATATTTTTGAATTTTGCGCTAGTCATACACCAAATTGGAACACCATTTCCATTTCGGGATATCACATCCGAGAAGCTGGAAGTACGGTTGAACAGGAATTAGCATTCACCTTTGCCAATGGTATTGCCTATGTTGAAGCGGCCATCGATAAAGGTCTTGATCCTAACCAGTTTGGACCTCGAATTTCCTTCTTCTTTAATTCTCATAATGATTTTTTGGTCACCCTGAAGT
ASV384	GGAACTGGATGAACAGTTTACCCCCCAGTTCCCCAGCTCCTGATAGTTGATAGTCAATAAGAAACAAGACTTTTGACTTTAATTGTTAATGGTTTCAAAAAGAATGATCAGCATTTTTAAAATTAACTCAAAACTTCTACTGGATTCCAAAGTGAATTTTAATTTTCATAAGACTTATGGTATGATTCTTTGGTCACCCTGAAGT
ASV385	GGAACTTGGTTGAACAGTATACCCTCCGTTCATGAGGGCTTTATAAGCCATAGTGATAAGGAAATTGGTGTGCTTAACAATATCATTTGGCAGTTTCCTTTTAAAAATACAGAAGAAGTTATTAATAAAGCAAATCGTTATTCAACATTGGGCGTTACAAAATTACAAGGCAAAGGTCGAGCTGGTGGAGTTTTTAAGGCCTTCTTGCATGGGCTTTGGGCTTTTAACAAACATTACATCTTTAAGCTTGATTCTTTGGTCACCCTGAAGT
ASV386	GGTACTGGTTGAACTGTATATCCTCCATGAATATGATCGCTTAACGGCGCATATCGATGAATTAGGCCAACGACTATAACAGCTCCAAAAACAAAAGCCCCCCGCCCCCAGTAATGAACCCTTGGCAGGATAACCTTCATGCGTCGTTACCAACTTTTTCTATATGATATGGTAGGCATCTTCTTTGTTTTTGCCATTCTTATCATCGTTATTAACTACAGTTTGACCCAATGGAACAGACCTGGTTTTTTGGTCACCCTGAAGT
ASV387	GGTACTGGTTGAACTGTTTAACCTCCAAACCCGAGGGATACGCCACCTTCAAGTCTTTTGCGATCAATTGTTTACAAGTTGCCATACCAGATGTGCCTTCCTGCGTAGAGCGATATCCAACTGCAGTGTTTATTTTATCATCCGGACAGCCTTTAGCTTCGCAGACTTCTTCAACTTCAGCTTTGGTCATTTTTATAACACCGTATTTGGTTCTTTGGTCACCATGAAGT
ASV388	GGAACTGGTTGAACATCCCCCAACTCTTGCGCAACAAGGCAAAGTGGCAAATAGCCCGCACCAACGCCGCCAAAGGCTTCCGGGATCGCGGTACCTTGCAGCCCAAGCTCCGCCAAACCCTGCCAGACATCGCTGGCCTGCAGGGATTCTTCTTCCATGATCGATCGATGTCGGCTCAAGGGGCTCTGCTCGCTCAAAAATCTGCGAACCTGTTCTTGGATCATTCGATCCTCGCTAGAAAAATCAAAATTCATCGGTGTCTTTATTCCTCGTCAGTTGTTTTACTGATTCTTTGGTCACCCTGAAGT
ASV389	GGTACTGGTTGAACTGTTTATCCCCCTTATCCAACTGTTTCCATCGCTTTTTGCACATATTTTTGTTGCTAAAACTATATCTTTTCTTTTATTGTTTTGATTGAACCAATTACCAATGATTTCTTCAGTTTTTCCATAAGTTTCAGCTTTTGTAGGAATTGAGTATACCTCTGCAGTATCAAAAAAATTAACCCCTCTTTCAAATGAGTAATCCATTTGTTTAAATCCATCATCTTGGTTCTTTGGTCACCCTGAAGT
ASV390	GGAACAGGATGAACAGTATACCCCCCTCATAATGCAATAGATGCAGTTTTAGATAATCGAATAAATGATGTTGATTTGTCCGATGAAGAAGCAAGTATTGCCTACAAATCTATCTCTGCTTGTAGTCAAATACTTACTCTGGATTTTATTGGTTTTTTGGTCACCCTGAAGT
ASV391	GGTACTGGTTGAACAGTATACCCTCCAAGACCCAGACGATGGACGAAAGACGATGGCCGCGATCAATGCGATGATCAGTGACCTCGGAACTTGGGCCTCAGGCATGCCGCTGGAAGAAGAATTGGCACGCACATGGAACGACGACATGATCTGGTGGGGTCCAGCAGGGATAGGTGCAACCTATACAATTAAGCGATATGCAAAACAACATTCTGGACCATTTCGCGCGGCATTCTCTGAAAGGTCATCGACAGGACACCTATGTCGCTTGGCAGAAGGTAACTTTGGTGATTTTTTGGTCACCCTGAAGT
ASV392	GGTACTGGTTGAACTGTATATCCCCCCACCAACTTCAACTTTGGTTAGCTGACTAGCCTGACGAGCGTGGGAAAGCTGGTTTTGCAGACATGCCTGATCTTTCTGGTCAGCATGGTCAGGATGGCCAGAATGGCCACCCTGATGACGCTGACCGCCATGCTCTCAAACTATCGCACTGACACATCTCCTTTGTGTTTGTGCTGGATCGTCGTTTGTTTGTTTGTTTGTTTGTGTTTGTGCTGGCTCGTCGTTTGTTTGGTTTTTTGGTCACCCTGAAGT
ASV393	GGAACTGGTTGAACAGTTTATCCTCCTCCCCTATTAGAAAAATCACGAAACCATGAAGAGGGTGGCGGAGTGGGTGGGTCAGTGAGAGTGTTTGCACTTGGCTAGTTCTTTGACTTCATCTTATTGGGGGTGCTGGTGGCTAGGTTTGCACATGTCATTGGCACCAGCAACGATTGCTCTTGGTTCTTTGGTCACTCTGAAGT
ASV394	GGTACAGGTTGAACAGTATATCCTCCTCTCCTCTACTTTCCCTTTCAATAGATATACTGCTGGGGATACTACCACTAGGTTTACAGTTATTGGTTGCATCAGGCCTTGCACTACTCTCTGGGGGTTCCATCATGTTACTTGGAATGGTCATGGGTTTAAAGTAGGTGCTGATCTCTGGTTCTTTGGTCACCCTGAAGT
ASV395	GGAACTGGTTGAACAGTATATCCTCCCCCCATTAAAGGTCCTCAAACCCCCCGAGGAGTAGAGGGAATGAGCGTGGTAGCTAAATTGTTTACAAGTGAACCAGCTTTCGTTGTAAACAAAACAATCCTTGTGAATTGGCATTGAATGCAAAGTTTTGTTGGATTGACTTTGCTGTCATGTTCATTTGATGTTTTAGTGATTCTTTGGTCACCCTGAAGT
ASV396	GGTACTGGATGAACTGTTTACCCCCCATAATTTTGGCCTAATTTATATTCATACTTAGTTGGAAGTGAATCCCAAAAGCTGATAAAAAAGTAATCACAGCATTAAATGAAGTTTATGAGAGTTACAGTATGAGACAATGTAAATTCAAGGATATCAAGTTGTGTCAGGTCAAGATAAAACTCATAGCTCTGGGCTGATATTGAGTAACCATGGTTCTTTGGTCACCCTGAAGT
ASV397	GGAACTGGATGAACTGTTTATCCTCCCACAAAAAATCAAACTCCACCAAGCCAAACAGCAACTTCAGCTGTGCAGAAGTTCAGTATTAGTTTTGCTTGCAACAGGGACCATGAAAAACATTATTTGTATCCATCTTTTTCCATCATTGGGGGGAGTTGATTTTTTGCTCACCCTGAAGT
ASV398	GGTACAGGATGAACTGTTTATCCCCCTGATTTTAACAATTATCTCTCCCCCTCATTCTCCAAAAATGATTGTCTTGGGGACTTAGACTTATTTTTTTTATTTGTTATGGAAGAAATTATCAGAATAAGACAGTCCATAATATTCTACGAATCTTAGTTTTTTTTAAATTTTTAGAATTTGATTTTTTGGTCACCCTGAAGT
ASV399	GGAACTGGATGAACAGTTTATCCCCCATGTGTCACTTGTTATGTGTCACATGTTATGTGTCACATGTCACGTGTCACGTTTAATGTGTCACATGTAATTTTTTTCTTCTTATGTTTTTGGACAAATTGGTGGAGCTAGTTGGGGGAGGGTCTTTTTATCAACGAGGCCTACCCTGATAGTTGAAGTAGCAACCTTTACTTGTATAGATAATTTGGTGATTTTTTGGTCACCCTGAAGT
ASV400	GGTACTGGTTGAACTGTATATCCCCCTCTGAGTTCTTATATTTTTCACGGGGGAGCATCGGTTGACTTTACAATTTTTAGACTTCACCTAGCCGGAGTTTCTTCTCTCCTAGGGGCTGTAAACTTTATTAGCACGGTTTTAAATTTACGGGCATTAGGTATGTTGATAGATCGCATACCTTTATTCCCATGGGCAGTATTTATTACTGCTATTCTGGTTTTTTGGTCACCCTGAAGT
ASV401	GGAACAGGTTGAACAGTATATCCCCCTCTGAGTTCTTATATTTTTCACGGGGGAGCATCGGTTGACTTTACAATTTTTAGACTTCACCTAGCCGGAGTTTCTTCTCTCCTAGGGGCTGTAAACTTTATTAGCACGGTTTTAAATTTACGGGCATTAGGTATGTTGATAGATCGCATACCTTTATTCCCATGGGCAGTATTTATTACTGCTATTCTGGTTTTTTGGTCACCCTGAAGT
ASV402	GGAACAGGTTGAACTGTATATCCCCCTGCACTCCTGTACTCCTCATTGTAAGGAAAGGAGGGGGCCTTACCTACGGTGACAGCCTTAACAGCTCAGGGAATGACAATAATGCATTTGTTTGTTGTGCAGGTCATAGTTAGTACAACACATGGAGACAATCAATACAGTGTACATAAACAAACAAACATCATATTCAATCTCACACCTTCAGGACACAGAAATCATCAGTTGATCCTGGCACCTCATACGGGGTGTTTCTTGAAAGAAAATAATTAAATGTTTCATTGTGGTTCTTTGGTCACCCTGAAGT
ASV403	GGTACAGGTTGAACAGTTTACCCCCCTCTGAGTTCTTATATTTTTCACGGGGGAGCATCGGTTGACTTTACAATTTTTAGACTTCACCTAGCCGGAGTTTCTTCTCTCCTAGGGGCTGTAAACTTTATTAGCACGGTTTTAAATTTACGGGCATTAGGTATGTTGATAGATCGCATACCTTTATTCCCATGGGCAGTATTTATTACTGCTATTCTGATTTTTTGGTCACCCTGAAGT
ASV404	GGTACAGGTTGAACTGTTTACCCCCCCCCATTTTCCACGTTGGCGGATTTTATAATAATATTATAAAACAAGACCAAGGTGATCTGTGCCGATCTCCTGGACTTTATTTTGGTTTCAATTTAATTTTGAGGAAATTTAAAGATTTTGTAAAATTTCAGTTAGGGTAAAGGCTCAATAACTGGCAGAGGTTTTGTCTCTTGATTTTGGTCTCCTTCTTTATTTTGTCCCCAGAAATTGGGTGATTTTTTTTTGTCCCAAGAGTTTAAGATATTTTTTTGCCCCGAGAGGTTTGGTTCTTTGGTCACCCTGAAGT
ASV405	GGTACTGGTTGAACAGTTTATCCTCCATTGATATTTTAATTTGATCATGACTTGCTTGACTGCTCTGCATCATCCAATACGTGATATACTTTGTATCAGACACAGGCAGTGAGGCAGCCTGCTCAAGCTCAAACAAATATCATTAACTTTTGGGATTTGTATAATATTTCCGAATTCATTAGGTTAGTTTATCTAGCTAACAAGTTTAAGCTGTTTTCAACCAGCTTATTTTCTTTAGATGTAATCACTTAAATTTAGTGATTCTTTGGTCACCCTGAAGT
ASV406	GGTACAGGTTGAACTGTTTACCCCCCCACGGGGCTATGATCAAAAAAAATAAGTTTCAGTATGAAAAACTTTAAATAAAAAAATTACACTAATAACACTAATAACACCAAGGATTTCCCTTGGCGGTCTTCCAGTACTTAAAGGTTAAATTCATAAATCAAGAATCAGGAATCTAATGACAGTACACTTTATAGGAGCAGGGCCGGGGGCGCCTGATTTGATCACAATTCGTGGACGCGACTTAATCGCAAAATGCGAGGTTTGCCTTTACGCTGATTTTTTGGTCACCCTGAAGT
ASV407	GGTACAGGTTGAACAGTTTACCCCCCTCTTTCAAGAAATATTGCCCATGCTGGTGGCTCTGTGGACTTTGCTATTTTTTCTTTACATCTCGCAGGGGTAAGATCTATTTTAGGTGCTGTTAATTTTATTAGTACTCTAGGTAATCTGCGAGTATTTGGTATATTGCTAGACCAGATACCATTGTTTGCTTGATCCGTACTAGTTACAGCTATTCTTTTACTCCTTTCTTTACCAGTTTTAGCTGGAGCTAATATCAACATCTTTTTTGATTTTTTGGTCACCCTGAAGT
ASV408	GGTACTGGTTGAACTGTTTATCCCCCTCTTTCAAGAAATATTGCCCATGCTGGTGGCTCTGTGGACTTTGCTATTTTTTCTTTACATCTCGCAGGGGTAAGATCTATTTTAGGTGCTGTTAATTTTATTAGTACTCTAGGTAATCTGCGAGTATTTGGTATATTGCTAGACCAGATACCATTGTTTGCTTGATCCGTACTAGTTACAGCTATTCTTTTACTCCTTTCTTTACCAGTTTTAGCTGGAGCTAATATCAACATCTTTTTTGGTTTTTTGGTCACCCTGAAGT
ASV409	GGAACTGGTTGAACTGTATACCCTCCCTGACAATTTCATTTCTGCTGCACTAGAAATTCTCTCTCGTATTGTAATCATCACCATCATCATCATCATATGGCCTGGGGTCACCCATCCATCTGGAGGCTGACCACCCCAGAAATCCAGGCACACATCATCCTTTCCTATTGACCTCTGGTTTTTTGGTCACCCTGAAGT
ASV410	GGAACTGGTTGAACAGTATACCCCCCAAAGCATTAAAGCACGGATTGCACTTAACCCTGCTGTACTAGCATTTCTAAATTCTGAGGCAAGCACGGTGGAAGTCTCATCTAAGGACTTCATAAACTTATAGATCATTGCAAATTCAGCAACACCTGTCCCTGATTCCCCTAACTCGTTGAGAGATGTTGCAAGTCTAGCAATTTTGTTTGCAGCTTTAACCTCTGGGTTGTCAGTCCACTTTTCGTTTATTCGTGTTAGGTGGTTCTTTGGTCACCCTGAAGT
ASV411	GGAACAGGTTGAACAGTTTATCCTCCAATAAACCGAGATACAAAATGAATAGATCCCGTAATAACCAGCAGTTTATCTTGCGGAAGTTGCGGGATCAAACTTGCATCATAAGCCGTAAGGGTAGATTGGCGATGAACATGTTCATAGACATCATTAACCGCGGCAGTAGTTTCTTGTTCAAATCCACAGATATATAATTGTTTCGCCGCAGATGTAATGGCATTCACCATCCCGTTATAGTCTTTGGTTTTTGGTCACCCTGAAGT
ASV412	GGTACTGGTTGAACTGTATATCCTCCTGTTAAGTTTGGTTTTATTAAACTTGTGAGATTTTCACCTAGAAGATCTGTTTTCATGCTTTTATGCTTTTATTCTTTTAAGCATTCTTTTTGCCTCTGTTAATTGATTGTTCAAAGACTTAATAGCCTCTTCCACTTGTTCTTTTTTTGTTGTGTCTTTTATCGTGGTTCTTTGGTCACCCTGAAGT
ASV413	GGTACAGGTTGAACAGTTTATCCTCCGCCACTTAATTTTAGATAATTAATATCTACTTTAGTGTTTTGAACTTTTGTACCCGCAACTGCAATCACTCCAAATGGAAACTTATTCTGGCTCCTACTTATAACAACAGGTTGAAGGCTTGTTCCATTAATATTGAGCCCACCTCTGACCAAAAATGACATACCTTCACTTAGCATAAGTGTTGTACCTGCTTGTATAACTACATTAAATCCATAAGGAGTAATAATGTTGCTATGATTCTTTGGTCACCCTGAAGT
ASV414	GGAACTGGTTGAACTGTTTATCCTCCAAAAAGTTTACGCTATTTCAGACATGCAATTTGACTAACTAAAACTATAAAAGGTGGTCGTAAATATGCTTGAGGTTTAGTTACCATAATATAATTGAAATTAATAGTATGATAAGTACCTAATCTATCATTTAGTGATTCTTTGGTCACCCTGAAGT
ASV415	GGAACAGGTTGAACAGTTTACCCCCCCTCTGTACTTTTGAAATCCTTGGAGGAACTTTTTTTAAAACTATATTTTAGACAAACTAAAGTTCCTCAAAATGTTTGGATTTTGGTCATCCTTCCCCATTTTTCTTGTAAAACATCCAATCCAATAGAAAAAAAGTTCCTCAAAATGTTGGTTTTTTGGTCACCCTGAAGT
ASV416	GGTACAGGTTGAACTGTTTACCCCCCTCAAAAAAAAATGTCCATTTCTGTTTGTTTTGGTATTGGTGGTACTATCCACATTGGTCAAGAGATTCAGTGTCTTCCGTATGCAAGATTTTTTTCTTCTGTTTTATGTAGTTCTTTTAAGATGATTTGTTCTTTATAAAGAGGACATTTATTGCAGGGTCTTTCTTTTCGCCACTCACAGAGAATTTGCAACATGTTTTGAGCTTAATCATATGATTTTTTGGTCACCCTGAAGT
ASV417	GGTACTGGTTGAACTGTTTATCCCCCAAATATTTTTTTCGCCATTTTTCAACTTTTTATTACTTTAATTTGATTTTCATCTTTCCAACATGCTTTTACTTTTTTATTTTATGCTTACATTAAGCCGGTTTATATCTTCGCTTATAAAATCTGGTTCTTTGGTCACCTTGAAGT
ASV418	GGTACTGGATGAACTGTATATCCCCCTCTGAGTTCTTATATTTTTCACGGGGGAGCATCGGTTGACTTTACAATTTTTAGACTTCACCTAGCCGGAGTTTCTTCTCTCCTAGGGGCTGTAAACTTTATTAGCACGGTTTTAAATTTACGGGCATTAGGTATGTTGATAGATCGCATACCTTTATTCCCATGGGCAGTATTTATTACTGCTATTCTGATTTTTTGGTCACCCTGAAGT
ASV419	GGAACTGGATGAACAGTTTATCCTCCTCTGAGTTCTTATATTTTTCACGGGGGAGCATCGGTTGACTTTACAATTTTTAGACTTCACCTAGCCGGAGTTTCTTCTCTCCTAGGGGCTGTAAACTTTATTAGCACGGTTTTAAATTTACGGGCATTAGGTATGTTGATAGATCGCATACCTTTATTCCCATGGGCAGTATTTATTACTGCTATTCTGATTTTTTGGTCACCCTGAAGT
ASV420	GGTACTGGTTGAACTGTTTACCCTCCTCGCCAAAAAATTCCAGATTAAATCGCGGAGCTATTTTTTCCAAATTGTCAATCTAACAAAGTGAAATGTTTTCCTGATCATAGACCTGGAGTATAAGTTTCAAGCATTCACAATGCGCATTATTAAATGGGTCTAGATAGAGTGCTGATTCTTTGGTCACCCTGAAGT
ASV421	GGTACTGGTTGAACTGTATATCCTCCTGAAAGTCGCAGTCCTCAAGATTTTTTTGCAACTTGAGGATTGTTTTTGCTCGATTTCGCTTCCGGATTTTATCTTTCCCTTTGATGGTGAGCAATAGACCGGACTCGGACGTTGCCAAGTACTTCTCAAAGTACTCTCGCGATATGCACATGGCATGTACCGGTGTCTTACAGATGATAGTGGCCGAGCGTATTCGCCGTGGATGTAGCAAGGCTCCCTCGCCGAAGAAGTCACCAGCTGTTCTCAATGCGCGAGATCCACTCTTGGTTCTTTGGTCACCCTGAAGT
ASV422	GGTACAGGTTGAACTGTTTATCCTCCAAATTTCACGTGTCACATGTCACGTGCCACATGTCACATGTCATGTGTCACATGTAACATGTCATAATTTTTTCAAAGAATCGGCCCTTAGGCCGATTCTTTCATAGAGTCGCGATGTCAGTTTGTCAATTATAACCTCCTGATCCGTGACATATAACCTCCTGATCCGTGACATATAACCTCCTGATCCTTGTAATATAACCTCCTGATTCTTTGGTCACCCTGAAGT
ASV423	GGTACAGGATGAACTGTATATCCTCCTGTCAAAGGGTTGTAACTTTTAGTGGGCATAGACAATAGAACAAACTAAATTTATAGTTTCAAAAGTTTTTTAGAAAACTTCTTATTTCTGATATCAAAGCTCAGCAAGGTGGGCAATTCTCCAATGCCAGTCTTCTTGAAAAGCTTCAAGGGAGTCTAGATTTTATAACCTTTACTATTGATTCTTTGGTCACCCTGAAGT
ASV424	GGTACTGGTTGAACTGTATATCCTCCTCTTTCAAGAAATATTGCCCATGCTGGTGGCTCTGTGGACTTTGCTATTTTTTCTTTACATCTCGCAGGGGTAAGATCTATTTTAGGTGCTGTTAATTTTATTAGTACTCTAGGTAATCTGCGAGTATTTGGTATATTGCTAGACCAGATACCATTGTTTGCTTGATCCGTACTAGTTACAGCTATTCTTTTACTCCTTTCTTTACCAGTTTTAGCTGGAGCTAATATCAACATCTTTTTTGATTTTTTGGTCACCCTGAAGT
ASV425	GGTACTGGTTGAACTGTTTACCCCCCTCTTTCAAGAAATATTGCCCATGCTGGTGGCTCTGTGGACTTTGCTATTTTTTCTTTACATCTCGCAGGGGTAAGATCTATTTTAGGTGCTGTTAATTTTATTAGTACTCTAGGTAATCTGCGAGTATTTGGTATATTGCTAGACCAGATACCATTGTTTGCTTGATCCGTACTAGTTACAGCTATTCTTTTACTCCTTTCTTTACCAGTTTTAGCTGGAGCTAATATCAACATCTTTTTTGATTTTTTGGTCACCCTGAAGT
ASV426	GGAACTGGTTGAACTGTATATCCCCCTCTTTCAAGAAATATTGCCCATGCTGGTGGCTCTGTGGACTTTGCTATTTTTTCTTTACATCTCGCAGGGGTAAGATCTATTTTAGGTGCTGTTAATTTTATTAGTACTCTAGGTAATCTGCGAGTATTTGGTATATTGCTAGACCAGATACCATTGTTTGCTTGATCCGTACTAGTTACAGCTATTCTTTTACTCCTTTCTTTACCAGTTTTAGCTGGAGCTAATATCAACATCTTTTTTGGTTTTTTGGTCACCCTGAAGT
ASV427	GGTACTGGTTGAACTGTTTATCCTCCTTCTGGTCCTAGATCAATAATCCAGTCTGCACACTTAATAACATCCAAGTTATGTTCAATTACTATAACTGTGTTCCCTTGCGTAACCAACTTTTGCAATACAGACATCAGCATTTGAATATCATCTACATGTAATCCCGTTGTCGGTTCATCTAAAAAGTAAACTGTGTTTTTTGTATTATTTTTTGAAAGCTCTGTAGAGAGTTTGATTCTTTGGTCACCCTGAAGT
ASV428	GGTACAGGTTGAACTGTTTATCCTCCGAATAAAAAACCCAATCCTTTTTTAATAACCGATTGACTTTTGTACCCCACGTGGTAGGATGAACACGATTTATTCTAGCGAATAGATCATTTAGGTTACCTAAAACAAACAAACAAACAAACAAGACTACTATGAAAAACAAAATACTAGCTATGCTAGTTGCTTTCGGTCTGGTGGGATCCGTTTCCGCTATCGAAATCAACGAAAACCTCTCCATCAATGGTTTCATCGATGATTCTTTGGTCACCCTGAAGT
ASV429	GGAACTGGTTGAACTGTTTATCCTCCATTAAGCACTTCTTTCATGAGTTTATCACCTTCAAGTACAGCTTATCTTATCTTTGGATTATTAATGTCAGGTATATCCTCATGTCTCACATCTCTTAACTTTTGGACAACAATTCTAAATCTGAGATCTTATTATCTGACATTAAAGACTATGCCATTATTCCCTTGGGCTCTCTTAATTACAGGAGGAATGCTTTTATTAACATTACCAATCTTTGGAGGAGATCCTATATTCTATCAACACTTATTTTGGTTCTTTGGTCACCCTGAAGT
ASV430	GGTACTGGTTGAACTGTTTATCCTCCACTAAATGAACCAACCATTGACCCCCAATTTTTTTTGCATCTATGGCTACTACCACACACTGCGCACCAAAAGCTTGCGATAATTCTTTAATAAGCTCTGGGCGCCTCACGGCCGACGAATTAATGGATACTTTATCTGCCCCATTCTTAAGGAGTATGTCTACATCTGCAACACTGCTTATTCCTCCCCCAACAGTAAAAGGAATGTCTACCGTAGCAGCTACTTTTAGCACTAAATCTGCCATGATTCTTTGGTCACCCTGAAGT
ASV431	GGTACTGGATGAACTGTATATCCTCCAACATTAGGTACACCTAATTACATTACAGCTGTAGATTACCAGATACCACAGCGCAGCCGGCGGCCGGATACACGAGTACGACGGCGACGACGACATTTACAATTTAGCAGGCAAGGCTGGGCTTGCTATAAACATGATTTTTTGGTCACCCTGAAGT
ASV432	GGAACTGGTTGAACAGTATATCCTCCGTAAAGTTAGTTCATCTAAGGAATCCTAAAGGAATCCTTAAGGCATCAAGCAAGGTTAGATCATCCCCAAGTAAGGTTAGGTAATCCCAGGAAACTTGAAATGGTCATAACTCGGGACCCTGGCCACCCCAGGAGCTGAGATTAAGACCACATGTACAGGACAATGTAAACTCGCGAATGAAACATACGAGGGCCTGCCTGGGGGACATTTGGGGACACTTATATGTGGAAAACAATGAAAAAACACAAAAAATTACCCCCAAATATGATTTTTTGGTCACCCTGAAGT
ASV433	GGTACTGGATGAACAGTTTATCCCCCTTGGTCAACTTTTTGCACATTTGACCTTGGAGGTCATTCAGGGTCAACATTTGCCATTTAGAAGAAAACAAGACCAGAGGTCTACAGCTCCTCCTCTAGTATCAGTTCTTCAGTTAGTTAATCAGTCAACCAATAAATCAGTCAATCAGTCTGGGATCCTCCTGGTTCTTTGGTCACCCTGAAGT
ASV434	GATACAGGATGAACTGTTTATCCCCCCTTCAAGATCCTACTTTTTTGTCTATTGCATCATGATTCTTGATCAAAACTACTTCCTAAATTGAAGGTATCTCCGCTTTCAGAATTTCTAGAGAACTCTTTGTGGTGTCTCAATGCAGTTGACATTTGTTTGCCAAACTCCAGATTTCCCAAGACCTCCCTGTTTAACTAAGAAAAATCTGGATTGCTCTCTTTTTTGGTTTTTTGGTCACCCTGGAGT
ASV435	GGTACTGGTTGAACTGTTTATCCTCCCGCTCCCATCCAAAAATACACTTTCTCATGAAAACCTTATTGTGTTAAAAGAATTAACAGTAAACAAGGAAATATACACTTCCTAAAAATTCAGTTCAAATAAATTGACCTACCAATACATAATGAAGCTATGCCATAAAGCTGCGGACAATAGGGAATTCGCTGCTATCATGAAAATACTCATTATTTTGTCAGATTAAGTACCAAAATTTAGGCTTCATTACTGCTGATTCTTTGGTCACCCTGAAGT
ASV436	GGTACAGGTTGAACAGTTTACCCCCCTTTTCTACAATTTTCACCTTTTTGAAACATTGGTTGACAAAACCTTCAATTCGTTTTGGGAGTTTCTTGGTAACTATATCTAATGGTTTATCATTGTCAACTAGTTTTGACAGTTGGTCAGTGTATGTGGTTTTATATTTAAACATTTTAAGTGGTTTTTTGGTCACCCTGAAGT
ASV437	GGTACTGGTTGAACTGTATACCCTCCTAATTGTAGTGGCTAGGCGAGGGATTCAGGTTATGGATACCAGCCCTTGAGAACCCCTCAAGTAGAACCGTGTCGACTTCGGTGTCCGTCCATCCGGCCGGCAGTGTAGAACATTTTTCCCCTAGACTAATGCCTTTGGCCTTTATTTCGGCGGCTGTGAAGGGAGTGTACAACTTGCCACTCTGAGTAACTGGATATTTGGCAGGTGCCATTACTGGTTTTGGTTTGGTATAGACTTTTGATTCTTTGGTCACCCTGAAGT
ASV438	GGAACTGGTTGAACAGTTTATCCCCCTTGTCAGAAATCAGATTTTGATGTATCAATTTGTTTAGAGAAAATACTCTTTTAAGGAAAAGGTATGAGACAATGTGAATTCAAGGATATCAAGTTGTGTCAGGTGAAGATAAAACTCATAGCTCTGGGCTTACATTGTGTAACCATGGTTCTTTGGTCACCCTGAAGT
ASV439	GGTACTGGATGAACTGTTTATCCTCCAAAAATATTTGTTTTCGCTATTTTTCAACATCTTATCCATTTATTTGGAGTTTCAGCTTTCTGACGTGCTTTTACTGGTTATTTTACGCTTACATTAAGCCATTTTGTGATGTTTTTCGTGAAATTGATTCTTTGGTCACCCTGAAGT
ASV440	GGAACTGGTTGAACTGTATATCCTCCTGGATATTTTTGAAGCTTTTATTGAGGCTTTTTTTGGGTGAACTCTGGTCACCATTTTGTCTATTTTTAAGGATTTTTTAACGGATTTTCATGGTACCATTTTTGGCATTTTGGGGTCCCCATTTGGTCACCCTTTAGGTTTATTGGGTTGGTTCTTTGGTCACCCTGAAGT
ASV441	GGAACAGGATGAACTGTATATCCTCCAGATGATGGTTCACTCAAACCTTATCACCTGCACTGCGCTGCGCCACACCGCACTAAATTTAACTGATTTGTACTGCATTAAACTTCACTTAACTGTACTGCAATCAACTGCAATTAACTGTACTGCACTACACTTTATCATACTGAACTGATTTGCACTGTACTACAGCTTCTTATGTTTTCACTACCCAGTTCAGTTGCTTTATACTGTATTGCACTACCCTGATTTTTTGGTCACCCTGAAGT
ASV442	GGAACTGGTTGAACTGTTTATCCTCCCACGGAAATGAAAACATGACCAATGATTGTCTGATTGACATGTATCAGACACAAGTCATACGCTGGTCAGACAGTTCCGCCAACAAGACCCATCCAACAATATGGATAAAGTTACATTGTATGATTTTTTGGTCACCCTGAAGT
ASV443	GGAACTGGTTGAACTGTTTATCCTCCTTATGTCCCTGGAAATTACATTAAAAAGGACTTTTATATTTTAAATGAAAATGTATGTTTCTCTACCATAGATTTATATACAAGAATCATTAAAATTATTTTCACTGGAGATGCGTGAATATAACCAAAGAATATAATAATTTGCCATATTTTTTGCATACATATGATTACGTAATAGTACTACCCGGGTGTTTTAAACAAACAAAACTCAAAAAAGCTATTTCCAATATGATTTTTTGGTCACCCTGAAGT
ASV444	GGAACAGGATGAACTGTTTATCCCCCCCACGAAAAAAATCAGAAAGCATGTCAAAATCGCGGGCTTTTGAACCAATTAGTGCAGTTCTAGATCAAAAACTGAAAAAAATGAAATTTTTTCAGTAAAATTCAAAATATCGGTGTTAATCTAAATTGGTTTTTTGGTCACCCTGAAGT
ASV445	GGAACAGGATGAACTGTTTACCCCCCTCTGAGTTCTTATATTTTTCACGGGGGAGCATCGGTTGACTTTACAATTTTTAGACTTCACCTAGCCGGAGTTTCTTCTCTCCTAGGGGCTGTAAACTTTATTAGCACGGTTTTAAATTTACGGGCATTAGGTATGTTGATAGATCGCATACCTTTATTCCCATGGGCAGTATTTATTACTGCTATTCTGGTTTTTTGGTCACCCTGAAGT
ASV446	GGTACAGGTTGAACTGTTTATCCTCCATTAGAGTGAATCCTCTGGGTGTTATCTCCCCCAATCGGGTGAATGAGTTGGTTACTCATTAAATGAGGAAGATAAAGACAATGAAACCGATAAAGAACTTCAATAGTTTGCTATCGAATTCCTTACCTTTCTTTGATTTTTTGGTCACCCTGAAGT
ASV447	GGAACTGGTTGAACTGTTTATCCCCCTTCTTTCTTCTTTTATTCAAGACTTGAACAACTCTAGTTCAAGCTAGTGATAAGAAACAAACGCTTTAAGAGTGATTGACCAGTGATCGGACACTGGATTTTATGATAATTAAGAATCTTCTGGTTCTATTAGTACTGACAGGGGCATTGACTGATCCAAAACGATATTTTCCGGAGTCGACTGGTTCTTTGGTCACCCTGAAGT
ASV448	GGTACTGGATGAACTGTATACCCTCCACTGCGAGGAAAAGGCATAACTTTCCTAAAATCCTGATTTATTTAGGATAACTTTCCTACTTTACTACTGTCCAATTATTTTCAAACTAGAAGTTAGCGTGACCTCCAGTCGCTCTAACTTCTAGCTCCTGCGGTGAGCCGGTGGCCTTCGGCCACCCCTTCCGCTGGCCCTCGTCAGGCAGTGCAGTGCAGACACCACCATCCTGATTTTTTGGTCACCCTGAAGT
ASV449	GGTACTGGATGAACAGTATACCCCCCATTCTGCAACCACAGCAACCTTTTCAGAAAAAGAAATCTAAAATGCTTGTTCGAACTTACAGCGAAGGTTCTAAAAAAGACTCTACCCATGTAAAAGATTTTGAATCAGTTCTCAGTCTGAATCTTGACAAAAACTCGAATAACACAGTTAGCTTTAAGTGGTTCTTTGGTCACCCTGAAGT
ASV450	GGTACTGGTTGAACAGTATATCCTCCTGCTGGATGAAATCCTCAACTGTCTTCTTCTTGTTTTCCATCAGTCTGACACAGCAATGTTTAGTGGATTGGAGGAGTTGAGACTCTACCTGACGATGGAGGCGTGCTTGTCGATCATCTCCTCTGTCGTCTCGGGGTCGATGATCGTGATCTCCCTGACGCTCTTGGTTCTTTGGTCACCCTGAAGT
ASV451	GGTACAGGATGAACAGTTTATCCTCCGATTAAAATAGATTGCGAAATACCCCGATTAAAATAGGGTTAAATAAGAATTGTTTTTTTCATTGGTAGCGAAAAAACATTGCACAGTTATAATATGACTTTTTAAGGAGAATATCCCATTAGTATCTACTGGTTATTTCACTGATTTTTTGGTCACCCTGAAGT
ASV452	GGTACTGGTTGAACTGTTTACCCTCCGTTTAATCGATGAGGAAACAGTGGGAATCTCGGCCGATGAAACAACCACGGCAGCAGATATTGCAACACTTTGGGATATCTTGATCGGGTCACATGATTTGGATGTGGATGTGGTAGCTCAAAATATTGGAGAAAACCTACCGAGCGGTCTAATAAGAACGACTGATTTTTTGGTCACCCTGAAGT
ASV453	GGTACTGGTTGAACAGTATATCCCCCTTAAAGGGACCACGCACATTGTTATGTTGAACACGATAACCAGACAATGACTCCAATGAACCATCATCTCGCCTTAACATGACCTCAACAATTAGCTCTCTATCAGGCATTCTCAGCGTTGTACGCAAATCATGATCCAAATCCAATAACTCAGCCGCATGATCAAATTGTTGCAAACCGGCCTCAAAATCAGACATGGCCTTTTTGTACTGCGCTTTCTTTTCACTGGTTTTCTTTTCACTGGTTCTTTGGTCACCCTGAAGT
ASV454	GGTACTGGTTGAACTGTTTATCCTCCCAGATACCATTTACGTCTAAGGTAGGTCTAATGCTCATTCTCTCATATGGAGTGTAATCGGACTCACCTTCATGTGCACCTATGTCTATACTTGATTTATGTGTTTCCTCACAAAATGGAGCTCTTGCCATAGCTTCTCTCTCATCAGAAGTTAGTTCTAAGACGTCGTCATAGAATCCATCGACTGTGATTCTTTGGTCACCCTGAAGT
ASV455	GGAACTGGTTGAACAGTATACCCCCCACTGTCGAGCTTCATGGCAATATCTTTTGGCATCTGAGTTGCGCGGTTCATTTTTTTAGGCTTGAAGATGTGCGAGTGTGAATGTCAGTCCTTACGTCAACATTGCATAGGATATGTTATACAATATCATGCACAAGACTATACTGTTACGACCTGCCTACGTTAACACCTCATGGGCCATGTTACCATATAATACCACACACAAGATTACACTGAACTACAGCGCATGAGTGACTGCTTTTGACCACACAGCCTGCACAGAGTAATTTGTTGATGATTTTTTGGTCACCCTGAAGT
ASV456	GGTACTGGTTGAACTGTATACCCCCCGAATAAAAAACCCAATCCTTTTTTAATAACCGATTGACTTTTGTACCCCACATGGTAGGATGAAAACGATTTATTCTAGCGAATAGATCATTTAGGTTACCTAAAACAAACAAACAAACAAACAAGACTACTATGAAAAACAAAATACTAGCTATGCTAGTTGCTTTCGGTCTGGTGGGATCCGTTTCCGCTATCGAAATCAACGAAAACCTCTCCATCAATGGTTTCATCGATGATTTTTTGGTCACCCTGAAGT
ASV457	GGTACTGGTTGAACTGTTTATCCCCCAACTGCACGAACTCTAATGTGAAATCCTGTGAATCCTTTTACTCTTGTAGCTTCTACTACTGAATTTGCAGCTTTCATTGCAGCGAATGGTGATGATTCGTATCTATCTGCAGTAACATGAATTCCACCAGAGCTGATGGAAACTGTTTCAGCACCTGTAAGGTCTGTCATGTGAATAATTGTGTTATTGAAAGTACTGAAAATATGTGCAATTCCCCATTTCTCTGGGCCTTCTTTTTTGGTTTCTGGTTGATTTTTTGGTCACCCTGAAGT
ASV458	GGAACTGGTTGAACAGTATACCCTCCCCTGAAATAACACCCGTCATTTCTTTCCGGTCTTGCAAATTGAGAAATGTAAAAATACTTTTTTCCTTTTTTGTCATGGTGAGTCGACCAGTCTTTTTGGTAGAAAGGAGGTAAATCGTATCTTGTAGTGTAGTAATAGAGCTGTTTGTGATACCCATTGTTACTGATATTGAAAGTGCACTTCCATTCTGGGACGTGTTTTGATAAGTAGTTTTGTTCTTGAAAGAGTAAAACTTTTTCTTCTTTTGTTAGCTGCTTGTTATGTAAGTTTTGGTTCTTTGGTCACCCTGAAGT
ASV459	GGAACTGGATGAACTGTATATCCCCCTTCCCTAAGCCGCAGCAGATAGCGCTTGCGTGATTTTCGATAACTCCAGATTCCAAGGCGTTTTTCAAAGGCATCGGCTTCAGCAAGAGCGTAGGTTTTGAAACCCTCAGGCCAGGAGTAGCGTGTGTTGAAGTAGCTGTGACCACGTTTTATCAACGCCAAATTAATGTTATGCCCCTTGACTTCCAAAACCGCAAGAAGCCGTCCATAGTTGCCCGTTTTGGTTTTTTGGTCACCCTGAAGT
ASV460	GGTACTGGATGAACAGTTTATCCTCCCTCAATTGTTGGGAATTTAAGATTTACTGAGCCCCTTTTTTTAAATCTAACTTTTTACATGCAGTAGGCGGTTTTTAAACTGACTAGTGTCCTAAAATTGCGACTTAGAAAAAAAATAAAAGATACTAGGTTAAAGTTCGAATCAATACGATTCCAATGGTGTGTAATATAAGTTGATAGGATCAATATTCACGGAACTGTGAATTTTTAAGAATCCGTTCCGTTTTTAAGTGGTTCTTTGGTCACCCTGAAGT
ASV461	GGAACAGGATGAACAGTATATCCTCCAAAATTAAATGGATCATCACTGTCATTGAGATCCTCAGTACTTTCCTCATTAGCCTCCAGGCTATTGATCTTTTTTTGTTTGGTTTTTTTGAACTTGCCCCTCCCCAAAGCCCAACAATTGTTAACATCATGATAGGACTTTTTGCAATGAGTGCAATAAAGATCAGATTTCTTTGATTCTTTGGTCACCCTGAAGT
ASV462	GGTACTGGTTGAACAGTTTACCCCCCTGTATTTTTGGAATCCTTCAAGGAACTTTTTTAAAACCTTATTTTAGACAAGCTAAAGTTCCCCAAGATGTTTGGATTTTAGTAATTTGCCCCAATATTTCTTGGAAAACGTCCAAATAAAGGGAATTAAGGTTCCTCAAAATGTCTGGTTCTTTGGTCACCCTGAAGT
ASV463	GGTACTGGTTGAACAGTTTATCCTCCCCTTTCTAGAAATATTGCACATGCAGGAGGATCTGTAGATTTTGCAATTTTTTCTCTTCATTTGGCAGGTGTCAGATCTATTTTAGGTGCTGTAAATTTTATTAGCACTTTAGGTAACTTACGAGTATTTGGTATATTATTGGACCGGGTACCATTATTTGCCTGGTCGGTATTAATCACCGCGGTTCTTCTACTATTATCTTTACCGGTATTGGCAGGAGGTGGAGATCCTATTTTATACCAAAATTTATTTTGATTCTTTGGTCACCCTGAAGT
ASV464	GGAACAGGATGAACAGTTTACCCCCCAGGCTGGCCTGATGTGTCCTGACGAGTCCCAGGACAACGCCCCCGTCATCACCAGGTCCGGCTTCCAGTTCCTGCTCATGGAGAGAGCCAGCCAGGTCCTGCCAAGATGACATCAATATAATTGGATGATTTAATTTAATTTTCCGAAATTCATCCTACACTCTCATATTAGGTGTGGTTCTTTGGTCACCCTGAAGT
ASV465	GGTACAGGTTGAACAGTTTATCCCCCCCCCCAATAACCTTTCGAAGTCAGAAAGGGCTCTTGATGGAATAAAATAAGCGTTTTAGTTCACTTAGTTTAACACAAAAATACCCAATGGGAACACAGATTAGGATTCCAAGAAGTTTGATGTGATTCTTTGGTCACCCTGAAGT
ASV466	GGTACTGGATGAACTGTATATCCCCCTCCGAGATTTGTTAGACACACTGAGTAACAAATGAAGGAATCAAAAGAAAATGTTGGTTGAGTACAACTTAAGGGTCAACATATTCCTGGTGAAATGTGCCCCCTGCTGTAATGATTTTACATCATTATCTGTGTTCAAGACCATTCCACATTTAGGGCAGTTGAACTCTTGCTTTTTATGGCACACATTGTTGTGTCTCCTTATGCAAAGTTGGTGGTTTTTTGGTCACCCTGAAGT
ASV467	GGTACTGGATGAACAGTTTACCCTCCCTTCTCCTGGCCAAACCAAAAATGTCAGTAACTTGTGAAATGAGGGACTGGGAGATTATACAATTGGTGGATTGGAATATTAAGGTATTGGGGGCATATGGGATTAGGTTTTTGGGGAAATTGGAAATTAAGGTATTTGGGGATTGAGGGCTTGGGGGATTGAGGGATAGGAGAGTTCGGGGATTGGCGAATTGGAAGATTTGATTTAAAGATTGGATATTTGGGAATTTGATTCTTTGGTCACCCTGAAGT
ASV468	GGAACTGGTTGAACAGTTTACCCTCCCCTATTTCCTTAAAATTGTATTTTCCCTTAATTCATCCTTCCCCATTTATTTGTGTTGAATCTGATATTACCCACCCTAAGGCTTTCAAATTTGCCATAAACCAAATTTATAATTCCCCATTCAGACTTTCCCCTTAAGATATCATATTGAATTCATAATCTCCAGTTATTTAATATAACAAAAAATCTCCAACCTAATACTATTTGATATATTTAAGCTATCTTTGTGTTTTTGGTTCTTTGGTCACCCTGAAGT
ASV469	GGTACTGGTTGAACTGTTTACCCCCCTCTTTCAAGAAATATTGCCCATGCTGGTGGCTCTGTGGACTTTGCCATTTTTTCTTTACACCTCGCAGGGGTAAGATCTATTTTAGGTGCTGTTAATTTTATTAGTACTCTAGGTAATCTGCGAGTATTTGGTATATTGCTAGACCAGATACCATTGTTTGCTTGATCCGTACTAGTTACAGCTATTCTTTTACTCCTTGTAAATTTAACCATGGTTATATCCTTTTCTTAGTTAGTTCAGTACATCTTTTTTGATTCTTTGGTCACCCTGAAGT
ASV470	GGTACTGGATGAACTGTATATCCCCCGTACCAGGGGTCTGAAATACAGACCCCCCCATTATATGGCGAAAAATGGAAATCATGCTAGTAGGTTGTTTAATAGCTTAAATGAAGCGTTTCGATGCACTGATTACAACGCAAAAAACCTCAGCTCTCTGCGAAGTCCCATTTCTGAAGAAATCAGGAAAATCTGTCAAAAATGATCATTTTTTCAGAAATGCTGGTTCTTTGGTCACCCTGAAGT
ASV471	GGTACTGGTTGAACTGTTTATCCCCCCCCACAGACATGTGCGCCAACAAATTTCCGCTAGTGTCGATGGGGGGCCGAGCAGAGGGTCTCGTGTGCACAGACCCGGGAAGGACCCCCATCTGCGCTAGCGGAATTTTAATCTTTTCTTTTCTCGCCACCGTTGTTCAAAACCAAGGGGTTGTCGTTTTTTTCTGATTCTTTGGTCACCCTGAAGT
ASV472	GGAACAGGTTGAACAGTATATCCCCCTAGTTGTGATTTGCAAGGCCCATATCTATGTATTATACATTCATAATGACCCCCTCTAAAGGCTCCATATTGCAAATTTTTGTATACATGCAATAGAATTCCCCGTTGGAGCTGAAAAACCTCTAAATGTCATGTATATTTCAAAGCACTGAGGTGAAGATATTAAGAATTTTTATACATAGAAAACAAAATTATTTTGAAAATTTCCTTTTTGGTTTTTTGGTCACCCTGAAGT
ASV473	GGAACTGGTTGAACTGTATATCCTCCTCTGTCCAGTTAAATAGAATTATACAAATTAGAATTCCACTATGTGGCCTAACTTCTAGCCTTCAGTGATAGTAGAAATTGTATTTGTATTGGTAAATTGTGAATTGTGTGTGAATAATTGACTGTGATACTGAGATGATTCTTTGGTCACCCTGAAGT
ASV474	GGAACTGGTTGAACTGTTTACCCTCCCAACCAATGAACTTTAAAAGCTCCCTCCGGAAAGATAGGATCTACATGCAATGTCACTCCTCCCTTCCCCGGGTTCTCATGTGTTTCATCGAATAATGTTTTAGCCTCATCAAAAAATGGCATTCGCCAATCATCAAAACCACCTATTTTACGTAGGTTTTTTCTATCGTTGTACTCAACTGCCTCATGCCAATTAACAAACTTACCCTTATCTTGCCATGGTTTTTTGGTCACCCTGAAGT
ASV475	GCCAGTGGCGATAAGTCGTGTCTTACCGGGTTGGACTCAAGACGATAGTTACCGGATAAGGCGCAGCGGTCGGGCTGAACGGGGGGTTCGTGCACACAGCCCAGCTTGGAGCGAACGACCTACACCGAACTGAGATACCTACAGCGTGAGCTATGAGAAAGCGCCACGCTTCCCGAAGGGAGAAAGGCGGACAGGTATCCGGTAAGCGGCAGGGTCGGAACAGGAGAGCGCACGAGGGAGCTTCCAGGGGGAAACGCCTGGTATCTTTATAGTCCTGTCGGGTTTCGCCACCTCTGACTTGAGCGTCGATTTTTGTGATGCTC
ASV476	GGAACAGGATGAACTGTTTACCCCCCTCTGAGTTCTTATATTTTTCACGGGGGAGCATCGGTTGACTTTACAATTTTTAGACTTCACCTAGCCGGAGTTTCTTCTCTCCTAGGGGCTGTAAACTTTATTAGCACGGTTTTAAATTTACGGGCATTAGGTATGTTGATAGATCGCATACCTTTATTCCCATGGGCAGTATTTATTACTGCTATTCTGATTTTTTGGTCACCCTGAAGT
ASV477	GGAACTGGTTGAACTGTTTATCCTCCACCGGCAATATTTACTGCACCGTAGCCACCCATTGAGTAACCTATAAGACCTGCTTTATCGGTATTGACGAGTCCTTTTAGAAAAGACGAAGAATCGCTACTAAGTCTTGCCATTTCATTTAATACAAAAAGATCATCTAAACTTCGGTTTAAAAGAGTGCTATTAAAATTATTTGCATCTTTAAATGTTGATTTTTTGGTCACCCTGAAGT
ASV478	GGTACAGGTTGAACTGTATATCCCCCATTAAGTAGTGTTCAAGCACACTCTGGGCCTTCAGTTGACTTAGCAATCTTTAGTCTTCACTTATCGGGGGCTGCATCAATTTTAGGGGCAATAAACTTTATTACTACCATCTTTAATATGCGCGCACCGGGTATGACAATGCATAGATTACCACTGTATGTTTGGTCTATTTTAATTACTTCATTCCTTTTACTTCTGTCTTTACCCGTATTAGGAGGAGCAATTACTATGTTATTGACTGATAGAAATTTTAATACTTCATTCTTTGGTCACCCTGAAGT
ASV479	GGAACTGGATGAACAGTTTACCCTCCTTACTAGTTTTCATCTTCCCTGGTTTCACCCTTAACTGGTTTCCTCCTACATCGGTTTCCCCCCGAACTGTTTTCCCTATATTGGGTTTCCTGTACTGATTTCCCCTGTACTAGTTTTTTCCCTGAATTGGAATTGGTTTCCTCAACTGGTTCTTTGGTCACCCTGAAGT
ASV480	GGAACAGGTTGAACTGTTTATCCTCCTCGCGACAAAGTGGGCATTACCGTATTTGACAGCTGCTTGAAGCGCAGCCTTGTCTATGGCTCTCTCCGCTCGGCGCTGTCGCCCGTGGGTATGAGAAATCAGCGTCACGTCGGCGGTGTCGAGCGCCTCGCTGACAGTGTCGAGCGCCTCGCTGATGGCGCGCAACCGAAACATGATTTTTTGGTCACCCTGAAGT
ASV481	GGAACTGGATGAACTGTTTACCCCCCGTCACAGACATCGACAAACTCTATATGGATCATTTGACTAGGGGTGACACCAGCCGCTAAGAGCAGGGTTTTGAAGGAGGGGTCTTCAAGGGCTCCCGAGTGGGATCTGGCCCCGTTTGCCAGCTCCTGGTTTTTTGGTCACCCTGAAGT
ASV482	GGAACTGGTTGGACTGTTTATCCCCCTTTATCTAGTGTAGCTGCTCACTCTGGGCCATCTGTAGATTTAGCTATTTTCAGTCTACACTTAGCAGGAGCATCTTCTATTTTAGTAACAGCTTTCTTATTACTGTTATCATTACCAGTTTTAGCTGGAGCAATCACAATGCTTTTAACTGATAGAAATTTTGGCACTGCCTTCTTTGATGCGCAAACGGGAGGGGATCCAGTTCTGTTTCAGCATTTGTTTTGGTTCTTTGGTCACCCTGAAGT
ASV483	GGTACAGGTTGAACTGTTTATCCCCCATAGCTTGGTAAAGCATACTGAATAATATTTTTGCCATTCGCGACAAAAGACGTGTATGTTCGTACCAAACATTTACCCGAGCCAAAAAAATTACCCTAGCAGCGCTAGGCTTGCTAGGTACATTTTCCATGTCTGGTCAAACTTTTTAGGGTGTGGGAGCATTTCATAGTTCCCAGGGTTATGGCACTATTTGTGATTCTTTGGTCACCCTGAAGT
ASV484	GGTACTGGATGAACAGTTTATCCCCCTCAGTCAATTTTAGAAGGAACTCCAGGATCAGGCATGGGAATAATTTTAATGCTTATATCTTTAATATGCGTACACCTGGTATGTCTTTATTTAAGATGCCACTATTTGTCTGGTCAGTATTATTTACTGCCTTCTTAATTGTCTTAGCTATGCCTGTATTAGGCGGAGCAATTACCATGCTACTCACAGACAGAAATTTTGGCACTAGCTTCTTTGATCCAGCTGGTGGTGGCGACCCTATCTTATTTCAGCATCTTTTCTGATTTTTTGGTCACCCTGAAGT
ASV485	GGAACAGGTTGAACTGTTTATCCTCCTCTTTCAAGAAATATTGCCCATGCTGGTGGCTCTGTGGACTTTGCTATTTTTTCTTTACATCTCGCAGGGGTAAGATCTATTTTAGGTGCTGTTAATTTTATTAGTACTCTAGGTAATCTGCGAGTATTTGGTATATTGCTAGACCAGATACCATTGTTTGCTTGATCCGTACTAGTTACAGCTATTCTTTTACTCCTTTCTTTACCAGTTTTAGCTGGAGCTAATATCAACATCTTTTTTGGTTTTTTGGTCACCCTGAAGT
ASV486	GGAACTGGATGAACAGTTTACCCCCCTGAAGCATTTTAACAGGGGATGGGTCATTGATATATGCCCTCTGGGGTAGAGTAGGTCTAAAATAGCGTAGAGGGTCACGTGTACTACGTTCTTTCAATCGCAGTACATTTTTAATAAATGATATGTCTCTATTGGTTGTGTTCATACAATGAAGTTGCCAAACGTGGTACAAGCTCTAACAGGTTCTCAGCTAATAAATCCTGCCACTCATCTTTGGTAATTTTATCATCATCTTTCTTGGCTTCTTTCATGTCTTCAATGATTCTTTGGTCACCCTGAAGT
ASV487	GGTACAGGTTGAACAGTATATCCTCCTCAGGCTAGATTGAAAACTTTCTGTGTGATCTAAAAACTTATAACCTTTATAACCAGATCACACAGAGATTCGGAATACAATGGTTCATGCCTCAACCGTGGCTCAACCATGGCTGAACCGCAGCCAATTAATTGTCCCGCTGTAATTTTCTAAAGTTGCACGTGACGAATCCGCCACGTGCCGTGTTAAAAAGAAAGTTTTCAAAATCATCAGCTTTTCCCTATGGTTCTTTGGTTACCCTGAAGT
ASV488	GGTACAGGATGAACAGTTTATCCTCCGTTTGGGGCCCGATTTCCGACCAGAACAGAAGGGTCCCCCCTTATGTTCAAGGCCAGCGGGCGGAAAAAACAGAACGGGCGAAAAAGCAAGTGGCCTCCGGCCGGCCCGGAGTCGATTTATTGAGATTGGGAATTAGTTAATTAAGGTCGGCAACTGTTTTTCCGCCCGGGCGAAAAAACAGATTCATATAACATGAAGAGCGCTAAGGTTACTGAACCTGCCCACAGCAAATCCCGCGCCTGATTTTTTGGTCACCCTGAAGT
ASV489	GGAACAGGATGAACAGTTTACCCTCCTTTTGTTGTCTATGAGCTCTATTACACTTGTGATTATTTTTTGTTCAGGGAATTCATTTGCATAGGTTCTAAGTTTCTTTGTTGCTTTCGATATTTTTCCCTTTATGTTTCTGATGTCGTTTTCAGCGTAATAAGTGACGACGCACATACGGTCGAAGCCTTCACTGTCTACCGTTCGAATATGTCTCTCAGCTTCCCTTCTGAGTGCATCGATAATGAGCATGCTGTCTAACGCTTCGAAGGCGTCTTTCCATGCTCTGATTATCTTGATTTTTTGGTCACCCTGAAGT
ASV490	GGAACTGGATGAACAGTTTATCCCCCTCTTGTACGTTTTACTTTACCTGATTTATACCAAGTGTAATAATAATCATCATTGATTCTCACTTTTTTGTTTTCTGCTAGAATATGTGCTTTCAAGTTATATTCATCATATTCGACAGATACACTTTGTGTCAATACATACTCTAATTCCTCAATTCGTTGACTGTAACATTGTGAGATAATGGCTAATAATAGCAAGCCTAATGTAAGTTTCCTTTTCATCTACTTATAAATTACTTTTTGTTCTTTCTGATAACTCACTATTAATGGTTTTTTGGTCACCCTGAAGT
ASV491	GGAACAGGATGAACTGTTTATCCCCCTCGTATAAAACACCCCATCGTACCTTATTGTTGCAGACTCAGTTGATGCTTGGCGTATTCGGTGCCAGCCTCAATCCCAAATATAGACAGTTAGAATTGTTTAGCATCGAGGACGTTGACGATGATTTTTTGGTCACCCTGAAGT
ASV492	GGAATTGGTTGAACTGTATACCCCCCTTGGACTTTTTCTTTTTCATGCCCAACTGCTTTTCGAGATGCCGGATACTCCTCTCCTCGGCTTCGTTCTCCTCTCTCAGTCGCTTTCGTCGCACCTTCTTATCCTCCTTAACCCTTCGCTTCTCCCTCTGTCTCTTCTTCCTTTCTTCCTTCTCCTCGCGCACTTTCGCGGCTGCGTCACGTGCTTCGGCAACACTGTCGGCGTCTCCTTCGTTGTCGTCAGAGACCTTCCCGTACTTCCTCTCGAAGAAGAGCTCTTTACCTGATTTTTTGGTCACCCTGAAGT
ASV493	GGTACTGGATGAACAGTTTATCCTCCATTTTTTGTCTAATTTGTTTTCGTAGTTTGATAAAAACATATTTTTTAAAGTCAGCAGCGCTTAATAAGAAATCAAAATCTTTTATTTGATATAGCTTTTTAAGTACCATAAACCCCTCCATGGGAATATATGGGATGATATGGGTTTTCAACTAATACGTCAATACCCTAATTTTAGCATTATTTTTCATTTTTTTTTAAAACGTAAAAGTTGATTTTTTGGTCACCCTGAAGT
ASV494	GGTACTGGATGAACAGTTTATCCTCCCACCCGAATAGTAGGCACCCGAATGACTTTTCCATTTAACCGCGAATAACATACGGGTTCTACGCAGATAAATGCAACTCCGGAATCCGAATAGTACAACATTACCAAGCATGTTCTGCTTCGTTAAACATATAAAAGATCAACATTTCCAGGCGGGGGTCCTGAGCATCCCGGGAATCCTGGGGGCGCATAAAGCATTGTTAAGTTTAAAATGTTCAAATGTCAGGAGCTTTGGTTTTTTGGTCACCCTGAAGT
ASV495	GGAACAGGATGAACAGTATATCCTCCTGCAGCTTCCGGTTTAAGGTCATCCCAGGAAACTTGAAATGGTCATAACTCGGGACCCTGGCCACCCCAGGCGCTGAGATTAATTAAGACCACATGTACAGGACAATTTAAACTAGCGAATGAAACACACGAGGGCTTCCATGGGGGACATGGGGTGACCCTTATATACGGAAAACCATAAAAAACACAAAAAGTTATTCCCAAATCTGGTTCTTTGGTCACCCTGAAGT
ASV496	GGTACTGGATGAACAGTATATCCCCCCTAAGGCAACGCCCTTGCAAAAAGATAATTCAAATACTTCTTCTTCTTCTGTACTGCATCACCGGGTGGTGCGTCGTGGACGTCCATCATCAGCGTTGGCAGCCCGCATTGCTCTTCTGACCACAGCCTTCCAGTCCTCTCTACTCTCTGCAGCACGGTGTATGGCAGGGGTACTCAAACCAGTCCATTCTTTAATGTTCGAGTGGTAATTGGTTCTTTGGTCACCCTGAAGT
ASV497	GGTACTGGTTGAACTGTTTACCCTCCTCTCCGAAGAAAAAATGGTTATTATGCCTTTTTTGTATATGTTGGGCCCATATTGATGTATTCTTATGGTCCAAATAAAATTATCTGTTGTATATTCTATCATTTCCATTGTAAACTAATTACGCACGGCGTCAGGGAAATTTCTTTTTAAAAACTCTGAAATTAAGGGATAGCATTCTGCTGGTACAAACACAGCAACTATGAGTGACTTGCCAACTCTTTTTTTTTGATTCTTTGGTCACCCTGAAGT
ASV498	GGTACTGGATGAACAGTATACCCCCCTATATATGTCCTCTGATCTTTTCATTTTTTTTCTTCAAAATTTAGATTTCTGAATATTGTTGTGTGTCTGACTAAATGCAGTTTCATTTGAATATTTTTTTCAAAAGCTCTTCCACAAATTATACATATTCTTTCAGCCACAGATGCTACTGGTTCTTTGGTCACCCTGAAGT
ASV499	GGTACAGGTTGAACTGTTTATCCTCCTGTATTCTTCTGTTTTCTTCAGTTATATCCTATAATATTTTGTTCTTTCCTGTTCTTTCCTCTTTCTCCTCTTTTATTTTGTTCTCTTCAACTCTTTTGTTCTCTATCTTATTAATTATTTTTGTGTCACCTGTTTTCTCTTGTTTTCTTTTGATATATCCTCTTCTTAGCCAGTATATCCTGGTCTGTATTGTTTTTTTTCTTCAGTTTTTTTTTCTCCAGTTTTTTCCTGTTATCTCATGTTACCTCCTGATTCTTTGGTCACCCTGAAGT
ASV500	GGTACAGGTTGAACTGTATATCCTCCTCTTTCAAGAAATATTGCCCATGCTGGTGGCTCTGTGGACTTTGCCATTTTTTCTTTACACCTCGCAGGGGTAAGATCTATTTTAGGTGCTGTTAATTTTATTAGTACTCTAGGTAATCTGCGAGTATTTGGTATATTGCTAGACCAGATACCATTGTTTGCTTGATCCGTACTAGTTACAGCTATTCTTTTACTCCTTGTAAATTTAACCATGGTTATATCCTTTTCTTAGTTAGTTCAGTACATCTTTTTTGATTCTTTGGTCACCCTGAAGT
ASV501	GGAACTGGTTGAACAGTATATCCCCCTTTTCTAGAAATATTGCACATGCAGGAGGATCTGTGGATTTTGCAATTTTAGGTGCTGTAAATTTTATTAGCACTTTAGGTAACTTACGAGTATTTGGTATATTATTGTTTGCCTGGTCGGTATTAATCACCGCGGTTCTTCTACTATTATCTTTACCGGTATTGGCAGGAGCTATTACTATATTATTGACAGATCAAAATTTAAATACAACTTTTTATGATGTAGGTGGAGGTGGAGATCCTATTTTATACCAACATTTATTTTGATTCTTTGGTCACCCTGAAGT
ASV502	GGAACTGGTTGAACAGTATATCCCCCTTTTCTAGAAATATTGCACATGCAGGAGGATCTGTGGATTTTGCAATTTTAGGTGCTGTAAATTTTATTAGCACTTTAGGTAACTTACGAGTATTTGGTATATTATTGTTTGCCTGGTCGGTATTAATCACCGCGGTTCTTCTACTATTATCTTTACCGGTATTGGCAGGAGCTATTACTATATTATTGACAGATCGAAATTTAAATACAACTTTTTATGATGTAGGTGGAGGTGGAGATCCTATTTTATACCAACATTTATTTTGATTTTTTGGTCACCCTGAAGT
ASV503	GGTACTGGATGAACTGTATATCCTCCAAAAATGGATCTTTGATTTTTCAGAGCTAAAATAATAAATTTTGCTCTAAAAAAAACAAAACTATGTTTTGAGAGAAACCTGTTTACCCTATATTGTAACATTTAACTTTTTATAGGAATACATTTTTCACTTATTTTTTTTATAGAGCTATATATCATCATTTTGGGATAAAATTTTTAAAATATTGGAATTTACCATTTTTAAACATTTTTCTATATTGTTTTTTGGTCACCCTGAAGT
ASV504	GGTACTGGATGAACTGTTTACCCTCCCCTTTACCCCCTTTCGTTAGTTCCTAGATCCTTCCCTGATATATACTTTGATTATTTCCTTTAGCCAAACAATAATATAGCAACAGCTGGCCACAAAATATGATGTCTGTGACTTCACGAATGATTCTTTGGTCACCCTGAAGT
ASV505	GGTACTGGTTTGAACTGTTTACCCCCCGACAATATGTTTCTCACTATTTTTCATCTTCTTATCCATTTATGTGGAGTTTCAGCTTTTAAACGTGCTTTTACTCGTTATTTGACCCTTACATTAAGCCATTTTTTGATGTTTTTCATCAAATTGTGGTTCTTTGGTCACCCTGAAGT
ASV506	ATCTCAAGAAGATCCTTTGATCTTTTCTACGGGGTCTGACGCTCAGTGGAACGAAAACTCACGTTAAGGGATTTTGGTCATGAGATTATCAAAAAGGATCTTCACCTAGATCCTTTTAAATTAAAAATGAAGTTTTAGCACGTGCTATTATTGAAGCATTTATCAGGGTTATTGTCTCATGAGCGGATACATATTTGAATGTATTTAGAAAAATAAACAAATAGGGGTTCCGCGCACATTTCCCCGAAAAGTGCCACCTGATGCGGTGTGAAATACCGCACAGATGCGTAAGGAGAAAATACCGCATCAGGAAATTGTAA
ASV507	TCGAGCAGGCAGAACGGGGTTCTGGAAAGCGACATCGGGGTAAAGTTTGACACCCGCAACTTCAGACTGGGGTTTGACCCAGTCACTGGTCTTGTCATGCCTGGGGTATATACAAACGAAGCCTTCCATCCAGACATCATTTTGCTGCCAGGATGCGGGGTGGACTTCACCCACAGCCGCCTGAGCAACTTGTTGGGCATCCGCAAGCGGCAACCCTTCCAGGAGGGCTTTAGGATCACCTACGATGACCTGGAGGGTGGTAACATTCCCGCACTGTTGGATGTGGACGCCTACCAGGCAAGCT
ASV508	GGAACAGGTTGAACTGTATACCCCCCTTTTATTATTGGAGAAGTTTTATTTGTTACTTCGTTTTGGGTACATAGGCTATTTTCCAAATGAGATTCATAAGAATAGTTCATCGCGTGTGTTCCTATTTTGTAATAAACAAATCATGAAAAGTAGACGACGTTTTTGTGGTTAGGGCAGAAATCCTTACAAAAATTTCGCTGATTCTTTGGTCACCCTGAAGT
ASV509	GGAACAGGATGAACTGTATACCCCCCTCTGAGTTCTTATATTTTTCACGGGGGAGCATCGGTTGACTTTACAATTTTTAGACTTCACCTAGCCGGAGTTTCTTCTCTCCTAGGGGCTGTAAACTTTATTAGCACGGTTTTAAATTTACGGGCATTAGGTATGTTGATAGATCGCATACCTTTATTCCCATGGGCAGTATTTATTACTGCTATTCTGGTTTTTTGGTCACCCTGAAGT
ASV510	GGTACTGGATGAACAGTTTATCCCCCATTAGCAAGTATTGCTTTCCATTCAGGAGGAGCGGTTGATTGTGCAATTTTTGCTCTTCACGTTGCAGGAGCTTCTTCAATTCTTGGAGCAGTAAACTTCATTACAACTGTAATGAACATGCGAGCACCAGGAATTAGCCTTCACCGAATGCCTCCATTTTTTTGAAGCACAAACTGGAGGAGACCCAGTGCTATTCCAACACTTATTTTGATTCTTTGGTCACCCTGAAGT
ASV511	GGAACTGGATGAACAGTATATCCTCCTCTGAGTTCTTATATTTTTCACGGGGGAGCATCGGTTGACTTTACAATTTTTAGACTTCACCTAGCCGGAGTTTCTTCTCTCCTAGGGGCTGTAAACTTTATTAGCACGGTTTTAAATTTACGGGCATTAGGTATGTTGATAGATCGCATACCTTTATTCCCATGGGCAGTATTTATTACTGCTATTCTGATTTTTTGGTCACCCTGAAGT
ASV512	GGTACTGGTTGAACAGTATATCCCCCACCCAAAACACCACAGATAGGTATTTTTTTTGAAGAAAAATTTTCAATTATTAATTCATCTCTTTGTTTTACTCCTTCATCTGAAATTTTTAACTTCCCTAAACGGTCGTTAAAATGGATATCAACACCTGCTATATAAAAAACAAAGTCAAAGTTTTCATTATTGAGTTCATTTAAATAAAATTTAAGTGTCTTTATATAGGCATCATCTTCTAGATTATCTTCAAGCTCAACATCTAAGTCACTCGTTGATTCTTTGGTCACCCTGAAGT
ASV513	GGAACTGGTTGAACTGTTTACCCTCCAGATGATGGTTTAGTCAAACCTTATCACCTGCACTTCCCTGCGCCACAACGCACTACATTGTACTGTAACCTGCACTTAACTGTACTGCACTACTCTGTACTATACTGAACCCATTTGCATTGTACTATACTGAACTGACTTGCCAGCTCTGCACTGCACTACAGCTTCATATGCTTCTCACAACCCAGTTCAGTTGCTTTATACTGTAATGCACTACCCTGATTCTTTGGTCACCCTGAAGT
ASV514	GGTACAGGTTGAACTGTATACCCCCCGCTTTCAAGTATTGCTAGCCACTCAGGTGGTGCTGTAGATTTAGCGATTTTTAGTCTACACTTATCAGGTGCTTCAAGTATTCTTGGTGCAATTAACTTTATTACAACTGTAATTAACATGCGTGCTCCAGGTATGAGTATGCACCGCTTACCATTATTTGTATGGGCAGTATTTATGTTAGCTGGTGATCTAATGTGGAATACTTGCTTCTTTGATCCTACTTTTGGTGGTGATGTTGTTTTATATCAACATTTATTCTGATTTTTTGGTCACCCTGAAGT
ASV515	GGTACAGGTTGAACAGTTTACCCTCCTCTTTCAAGAAATATTGCCCATGCTGGTGGCTCTGTGGACTTTGCTATTTTTTCTTTACATCTCGCAGGGGTAAGATCTATTTTAGGTGCTGTTAATTTTATTAGTACTCTAGGTAATCTGCGAGTATTTGGTATATTGCTAGACCAGATACCATTGTTTGCTTGATCCGTGCTAGTAACAGGTGGGGACCCTATCTTATACCAACATCTTTTTTGGTTTTTTGGTCACCCTGAAGT
ASV516	GGAACAGGATGAACTGTATATCCCCCTCTTTCAAGAAATATTGCCCATGCTGGTGGCTCTGTGGACTTTGCTATTTTTTCTTTACATCTCGCAGGGGTAAGATCTATTTTAGGTGCTGTTAATTTTATTAGTACTCTAGGTAATCTGCGAGTATTTGGTATATTGCTAGACCAGATACCATTGTTTGCTTGATCCGTGCTAGTAACAGGTGGGGACCCTATCTTATACCAACATCTTTTTTGGTTTTTTGGTCACCCTGAAGT
ASV517	GGAACTGGATGAACAGTTTATCCCCCACATATGAATACATTCTTTCTTTCATCTAGATACTTACGAATGAGTTTGATCTGTTTCGTGTGAATTGTTGTCACGGTATTTATCTCTTCTTTTTTTTGCTCGATTACTTTAATGAAAGAGTCCATTGATGATCTTACTAATCAGGCCATAGATTTAGTGCTTGAAAATGACGCACTACATAAACGTATCGTAGAACCTTTAAAAAGGAAAATTTTACCATACGTTGCATGTGGAGTTCTTACCAATGTGGTTATGTTGATTTTTTGGTCACCCTGAAGT
ASV518	GGTACAGGTTGAACAGTTTACCCCCCTCTTTCAAGAAATATTGCCCATGCTGGTGGCTCTGTGGACTTTGCTATTTTTTCTTTACATCTCGCAGGGGTAAGATCTATTTTAGGTGCTGTTAATTTTATTAGTACTCTAGGTAATCTGCGAGTATTTGGTATATTGCTAGACCAGATACCATTGTTTGCTTGATCCGTGCTAGTAACAGGTGGGGACCCTATCTTATACCAACATCTTTTTTGGTTTTTTGGTCACCCTGAAGT
ASV519	GGAACAGGTTGAACAGTTTATCCCCCTCTTTCAAGAAATATTGCCCATGCTGGTGGCTCTGTGGACTTTGCTATTTTTTCTTTACATCTCGCAGGGGTAAGATCTATTTTAGGTGCTGTTAATTTTATTAGTACTCTAGGTAATCTGCGAGTATTTGGTATATTGCTAGACCAGATACCATTGTTTGCTTGATCCGTGCTAGTAACAGGTGGGGACCCTATCTTATACCAACATCTTTTTTGGTTTTTTGGTCACCCTGAAGT
ASV520	GGTACAGGTTGAACAGTATATCCCCCTCTTTCAAGAAATATTGCCCATGCTGGTGGCTCTGTGGACTTTGCTATTTTTTCTTTACATCTCGCAGGGGTAAGATCTATTTTAGGTGCTGTTAATTTTATTAGTACTCTAGGTAATCTGCGAGTATTTGGTATATTGCTAGACCAGATACCATTGTTTGCTTGATCCGTACTAGTTACAGCTATTCTTTTACTCCTTTCTTTACCAGTTTTAGCTGGAGCTATTACTATATTTTTGACGGACCGAAACATCTTTTTTGGTTCTTTGGTCACCCTGAAGT
ASV521	GGAACAGGTTGAACTGTATATCCTCCCGGGCGTATTCATTCCTAGATCATAACCGGTAACTATAACTTCATCGCCCTCAGCAAATAATGTTGACGCTGAGTCTGTTACAATACCAGCAGCATCAATACCAGGTACAAAAGGATAATTTCTTGTGACACCTTTAATACCAGTTGCTGATAATGCATCTTTATAATTAAGAGATGAGTGAGAAACTTGAATCTGCACAAACCCCTGCCCAGGTTTAATTAAATCCAGTTCAGCTATAGAGGCTGAGAAGTTACCTTCTGATTTTTTGGTCACCCTGAAGT
ASV522	GGTACAGGATGAACAGTATATCCTCCAGAGTTCCTACGCCAAAGACGAGTTAGTCGCCTGTGGCATGGGTGATTTATTCGGTCCCGGCAACGCGAAGTTGCCGATTGATAACATGTTGATGCTCGATCGCATTGCGGAGATCAATAGTGACGGCGGCAAGGCCGGCAAAGGTCTGATTTTGGCTGAGCTCGACATACACCCGGACTTGTGATTTTTTGGTCACCCTGAAGT
ASV523	GGAACTGGTTGAACAGTTTATCCTCCATTATCAAGTATCTTAGCACATTCAGGTGGTGCTGTTGATTTAGGTATTTATTCACTTCATTTAGCTGGTGTTTCTTCTATTTTAGGTGCAATTAACTTCATTGTTACAATAACTAACATGCGTGCTCCTGGTATGACTGCTAACAGAACGCCTCTATTTGTTTGAGCTGTTTATATTACAGCTTTCTTGTTGTTAACTGATCGTAATTTTAACACTACATTCTTTGATCCAGCAGGTGGCGGAGATCCAGTATTGTTCCAACATTTATTCTGGTTTTTTGGTCACCCTGAAGT
ASV524	GGTACTGGATGAACTGTTTACCCCCCTCTTTCCAATGCGGATTACCATCCCACCCCGGCCGTTGACTTCGCTATCCTCAGTCTACATTTGGCGGGAGCGTCTTCTATACTTGGTGCCATCAATTTCATAACGACGATAATTAACATGCGGGCGCCGGGTATGACTTTTCATCGCATGCCGTTGATTTTTTGGTCACCCTGAAGT
ASV525	CTTTCTTCCCCTTTTCCCCTCCCTCCTCCTTCTTCAGCTTCGAGTTCCCGGAGACGCTGCCGGCGCCGTTCGTTGGCGAGGACGGCGTTGCTTACCTGAAGTTCGCACCGAGTTGTGGTCACGTCAAGTCCGGAGGCACTAAGGCGATCACAGCCACGTTCGAAGCGCCAGTGAAGGTAGGATAAACAGTCGCGCAGAGGAACATCTGAGATTTCATGGTCGGTGATTTTTTGGTCACCCTGAAGT
ASV526	GGTACAGGTTGAACTGTATACCCCCCTTATCTACTAGTGAATTCCATTCTGGTGCTTCAGTGGACTTAGCTATTTTTAGTTTACATATTGCTGGTGCTTCGTCAATTGCGGGTGCAATAAATTTTATTACAACTATTTTTAATTGCCGTGCTCGAGGTATGACTTTAGTCCGTATGCCTTTATTTATCTGATATCATTGTTGGTGGTGAAATGTTAACTCAACATGGAGGTTCGCCGTTACTGTATCAACACCTTTTCTGGTTCTTTGGTCACCCTGAAGT
ASV527	GGTACTGGTTGAACTGTTTATCCCCCAGATTCTATTTAACAAATCAGATAATTCGAAACAGACAAACAACAAAACAAGTAATTCTAAATAAAATAAATAAAAGAGATTTATTTTCATGAAGTGATAGAGTCAACATAAACTGACACAGTTCACTTGTAACAAAGCTTTAAGTGGTTTCTTTTCAATGTATATGCTCTCATTCAGTTTTCTTTGGAGGAATGGTATAGCAGGATTTTTATATCTCTCTGTGTTTGCCTTTTATTCACATGAAATGATTCTTTGGTCACCCTGAAGT
ASV528	GGTACAGGATGAACTGTATATCCTCCTCTTTCAAGAAATATTGCCCATGCTGGTGGCTCTGTGGACTTTGCTATTTTTTCTTTACATCTCGCAGGGGTAAGATCTATTTTAGGTGCTGTTAATTTTATTAGTACTCTAGGTAATCTGCGAGTATTTGGTATATTGCTAGACCAGATACCATTGTTTGCTTGATCCGTACTAGTTACAGCTATTCTTTTACTCCTTTCTTTACCAGTTTTAGCTGGAGCTAATATCAACATCTTTTTTGGTTTTTTGGTCACCCTGAAGT
ASV529	GGAACTGGATGAACTGTTTATCCCCCTCTTTCAAGAAATATTGCCCATGCTGGTGGCTCTGTGGACTTTGCTATTTTTTCTTTACATCTCGCAGGGGTAAGATCTATTTTAGGTGCTGTTAATTTTATTAGTACTCTAGGTAATCTGCGAGTATTTGGTATATTGCTAGACCAGATACCATTGTTTGCTTGATCCGTACTAGTTACAGCTATTCTTTTACTCCTTTCTTTACCAGTTTTAGCTGGAGCTAATATCAACATCTTTTTTGGTTTTTTGGTCACCCTGAAGT
ASV530	GGAACTGGTTGAACTGTTTATCCTCCTCTTTCAAGAAATATTGCCCATGCTGGTGGCTCTGTGGACTTTGCTATTTTTTCTTTACATCTCGCAGGGGTAAGATCTATTTTAGGTGCTGTTAATTTTATTAGTACTCTAGGTAATCTGCGAGTATTTGGTATATTGCTAGACCAGATACCATTGTTTGCTTGATCCGTACTAGTTACAGCTATTCTTTTACTCCTTTCTTTACCAGTTTTAGCTGGAGCTAATATCAACATCTTTTTTGGTTTTTTGGTCACCCTGAAGT
ASV531	GGAACTGGTTGAACTGTATATCCCCCAGCCCCGCCAGATTCCGCCGGATACACTCAGTGTGAGTGTATACGGCGGCTTGAAAAATGGCCGCCGGATACCCTCAAGCATAAAAAACATAAAAAAGTTCAAATTTTTTCATTATTTTTCATTTCTTAAATGGATACATTGAAAGTACCAGTTTTTCATGATTCTTTGGTCACCCTGAAGT
ASV532	GGTACTGGATGAACAGTATACCCCCCTCGGTATTGGCATCCCACTTGATGAAACACAGAGAACCCATGAACCCTGGGTGACGGATTTTAGCCTAGAAGATTACGCGGGTGAGGTGTTGATTGATGGCGTGGGGGCTTTGTGTGACGTCGTCAAAAACAGTACTCAGAAAGTCAGCATTATTTGTATCGGTCCTGTTCCCAACATTGCAGCGGCACTCGCACGTATGCCTGATATGGTCAACAACTCGAGGTTTATCGGCATGCACGGGAGTATTCGACGTGGTTTTTTGGTCACCCTGAAGT
ASV533	GGTACTGGTTGAACAGTTTATCCTCCATTAAGTAGTATTGAAGTTCATTCTTCAGCAGCAGTGGATTTACTTCTATTAACTTTACTTTAACATTCTTAATTAATCGTATTATGGGCTTATTAGTCATTAACTGTTTATATTCTGTTTGTACTATTGTTACAGCATTATTACTAATTGTCGTTCTACCAGTCTTAACTGCAGCATTATTTATGTTAGCAGGTGACTTAATGTGGAATACTTGCTTCTTTGATCCTACTTTCGGTGGTGATGTAGTTTTATATCAACACTTATTCTGGTTCTTTGGTCACCCTGAAGT
ASV534	GGAACTGGTTGAACAGTATATCCTCCTAACGACAGTCAGAGTTGCACTTACTAATTGAATTTGGGATTCCACTCCATAGCAAATATAAAAGATTGACATGGCTTAAATCCAAAGCTGAAATACCAATATTCTATCTGTTTTTTACCTATACTTCACTCTTCCCCTGAACCATTAGAGGGTGGTAGACTGGGGTCATGAATATTCACTTTAAATTATTGGTTCTTTGGTCACCCTGAAGT
ASV535	GGTACAGGATGAACTGTATATCCTCCTGCTTCACCAACATAAATTTTATTCTCATGAATATATTTTGTAGGCAAACTGAAGTCACCCTTCCCTCCAACTCTTTTTATTGGCTTTCTATTCAATTCATAATGCTCATCATACCAAGCGATAGTTTCATTGAGATATCTCCCTGGTTCTTTGGTCACCCTGAAGT
ASV536	GGAACTGGATGAACTGTATACCCCCCTCCAATTACAACGACATGTTTGTTTGTTGCCATGATTTGATCGTCACATTTATCACCTGCAACAACCTTATTTTGAAGTGGTAAGAAATCCATTGCGAAATGTACGCCATCTAAATCCCTCCCTGGTTTTTTGGTCACCCTGAAGT
ASV537	GGTACTGGTTGAACTGTTTACCCTCCTCTAAGTCATATTACGAGCCACTCTGGTGGTGCAGTTGATTTAGCTATTTTCAGTTTACATTTATCTGGAGCGAGCAGTATTTTAGGGGCGATTAACTTTATTACCACTATCTTTAACATGCGTGGGCCTGGTCTGGGCTTCCATCGCTTACCTTGGTTCTTTGGTCACCCTGAAGT
ASV538	GGAACTGGATGAACTGTATACCCTCCTCTAAGTCATATTACGAGCCACTCTGGTGGTGCAGTTGATTTAGCTATTTTCAGTTTACATTTATCTGGAGCGAGCAGTATTTTAGGGGCGATTAACTTTATTACCACTATCTTTAACATGCGTGGGCCTGGTCTGGGCTTCCATCGCTTACCTTGGTTCTTTGGTCACCCTGAAGT
ASV539	GGTACTGGTTGAACAGTATACCCTCCTCTAAGTCATATTACGAGCCACTCTGGTGGTGCAGTTGATTTAGCTATTTTCAGTTTACATTTATCTGGAGCGAGCAGTATTTTAGGGGCGATTAACTTTATTACCACTATCTTTAACATGCGTGGGCCTGGTCTGGGCTTCCATCGCTTACCTTGGTTCTTTGGTCACCCTGAAGT
ASV540	GGAACTGGTTGAACTGTATATCCCCCTCTAAGTCATATTACGAGCCACTCTGGTGGTGCAGTTGATTTAGCTATTTTCAGTTTACATTTATCTGGAGCGAGCAGTATTTTAGGGGCGATTAACTTTATTACCACTATCTTTAACATGCGTGGGCCTGGTCTGGGCTTCCATCGCTTACCTTGGTTCTTTGGTCACCCTGAAGT
ASV541	GGTACAGGATGAACAGTATACCCCCCTCAGTCAATTTTAGAAGGAACTCCAGGATCAGGCATGGGAATAATTTTAATGTGTGTATCTTTAATTTTGTTTGTAGCTGGATTTACTATGGGCGGATTAAATTATTTGTTTGATCTATGCTAGTAACTTCATTTTTATTATTATTATCTTTACCTGTTTTAGCTGGAGCTATTACAATGCTTTTAACTGATCGTAATTTAGGTACTTGATTTTACGAGTATGAAGGTGGTGGTGATCCAGTATTATTCCAGCATTTATTTTGGTTCTTTGGTCACCCTGAAGT
ASV542	GGTACTGGTTGAACTGTTTACCCTCCGTCAATTCTTAATCCAGTGTCTAAGATGCTTCCCCTAACAATATCTTTTTCAACATTCTTAAATACACTTTTAATATCGGATTCTGAAACATCTAAATCCTCATTATCTGAAAACTCTGACAACAGCTCATTCTTTATATCCGGTATTTTATTAGATCTAGCCTGTTTGTCGCTTTCTTTATAAGCGTCGATCAATTTATCTTTTACTGAGTCATTTACTGTTTTTTGGAGATCAGATAGATCAACCTCTATTAACTCTCTTGGTTTTTTGGTCACCCTGAAGT
ASV543	GGTACTGGATGAACAGTTTATCCTCCTCTTAGAAGGAGTTTGGCTCCGGGCCCTCTATTGATTACTACTATTCTATTATTACTATCCTTGCCAGTTTTAGCTGGGGCTATTACTATATTATTAACAGACCGAAACTTAAATACCTCCTTTTACGACACAGGTGGAGGAGGCGACCCTATTCTTTACCAACATTTATTTTGGTTCTTTGGTCACCCTGAAGT
ASV544	GGTACTGGTTGAACAGTATATCCTCCGTTATCTGGTAATCAAGGTTCTCATTCAGGTCCTGCAGTTGATTTAGCTATTTTTAGTTTACATTTAGCGGGTGCATCATCTATTTTAGGTGCTATTAATTTTATGCCTACGATTTTAAAAGCTGGCGAAGTTTTAGATTATGGAGGAGGAAGTCCAATTTTATTCCAACATCTATTTTGATTCTTTGGTCACCCTGAAGT
ASV545	GGTACAGGTTGAACAGTTTACCCCCCTGTCTCACATCTCTTAACTTTTTTATTACAATTCTTAATCTGAGATCTTATTATCTTACATTAAAGACTATGCCATTATTCCCATGGTCTCTTTTGATAACAGGAGGAATGCTATTATTAACATTACCAATCTTATCAGGTGCATTATTAATGGTCTTGGCTGATCTTCATTCTAATTCATCATTCTTTGATCCAATCTTTGGAGGAGATCCTATATTCTATCAACATTTATTTTGGTTCTTTGGTCACCCTGAAGT
ASV546	GGAACAGGTTGAACTGTATACCCTCCTTACTTTGATCTCTATTGATTTGCTCTTATTGGTTCCTTTTTCTCTGGCCCCGTGTGGTCGGTTGTTCGACTCGGGCGGTGCCCCTTTCTTTCCTTCTTACTCTTTGTTCTGTTTCTCTGTGCTCTGCCTTTTGTGGTTCTTTGGTCACCCTGAAGT
ASV547	GGAACTGGATGAACTGTATATCCCCCATTTTTTGTCTAATTTGTTTTCGTAAGTTGATAAAAACATATTTTTTTAAGTCAGCGGCGCCGTTTGCAAAATCAAAAAACTTTCTATGATTTAACTTTTTTAGCTCCATATATCCCTCCTATGGGAATACATGGGAGCATATGGGTTTTCAACCTACACGTCAATACCCTATTTTTTCGATCATTATGGTAAAAAACCCATATTTTTCTATTAATCGTAAAGATTGATTTTTTGGTCACCCTGAAGT
ASV548	GGTACTGGTTGAACAGTATACCCCCCTCAAGCAATTTTAGAAGGAACACCGGGATCTGGCATGGGAATAACTTTAATGCTTATATCTTTAATATGCGTGGACCTGGATTATTAATGCATCGCTTACCTTTATTTGTATGGAGTGTTTTAATTACAGCGTTTTTACTTCTTCTCTCATTACCTGTACTTGCAGGTGCAATTACAATGTTACTAACTGATCGAAACTTTTCAACCAGTTTCTTTGACCCAAGTGGTGGAGGAGACCCTATTTTATATCAACATTTATTCTGGTTCTTTGGTCACCCTGAAGT
ASV549	GGAACTGGATGAACAGTATATCCTCCTGAATCTCTTAATATATCCTCCTGAATCTTTTAATATATCCTCCTGAATCTCTTAATATATCCTCCTGAATCTCTTAATATATCCTCCTGAATCTCTTAATATATCCTCCTGAATCTTTCTTCTGGGCCAGCTGGGTATTAACTCATATTGGTCCAAGCTAAGTGCGAGCACATTCACGATGATTTACAGAGATGGCAGGTAAATATAGTGACCACTATTTTTAAAGGTGCAGGGCAAACATAATGACCACAATTTTGATTCTTTGGTCACCCTGAAGT
ASV550	GGAACTGGTTGAACTGTTTATCCCCCTATTTTTTTTTAATCGAAAAGTATATATGCATGCTACCATTGGATTGTAAAATTAACCATAGCAGCAAGTATGATATGCTCTACCTAATTTGGTATGTATGAGCTCTGTCTCTTGAATCACAATTCAAGGAACGATCAATGGTTATGAGAGCATAGGAGGAATTATATGACTTGTGATTCTTTGGTCACCCTGAAGT
ASV551	GGAACAGGTTGAACTGTTTACCCTCCTCGGAAAAAAATGTTGACCTCCGGCCGTGAAAAGTCGCTAATCAGAATATTTTTTAGTTCAAAAAATGGATAAATAAAAAAAATATTGAAAAAACTAATTATAGGCTTAAAATTTGACATGAGTGATTCTTTGGTCACCCTGAAGT
ASV552	GGTACTGGTTGAACTGTTTATCCCCCCTGTCGGTTATGATTATGATCACAGATTCAATGGTTATTTTTTATGGCTTCCCTTGATAGAATAATATTTCAACACTTCTCAGTGACACAAATATCCTGTCTTGTTCAAAGCCTATGGACTGCATCTGGCTTGATTTTTTGGTCACCCTGAAGT
ASV553	GATACAGGTTGAACTGTTTATCCTCCCCATCCTTGCAGTTCTGAATTCCATCACAAACAGCATATAAATCAATACACCTCCCATTGTTGCACTTCCAGAACTCAATATCTCCAAACTCACCCTTCTCTGGACACTCATCCTTGCAAGCACTGATTCTTTGGTCACCCTGAAGT
ASV554	GGTACTGGTTGAACTGTATATCCCCCACTCATATCTGCTCTTTCTACCCTTATCAATGTTAGTACACAGATTCACATCGCAATACATAGAAACTAATGTACTCTGCCATATGTAAGAAAAAAAACACAGAAAAGTTTAAAGAGTCTCCAAAACTTATTTGACCACCAATCCCCCATTTGTGACTGGTTGTTTTGTGATTCTTTGGTCACCCTGAAGT
ASV555	GGTACAGGATGAACTGTTTATCCCCCTCTTTCAAGAAATATTGCCCATGCTGGTGGCTCTGTGGACTTTGCTATTTTTTCTTTACATCTCGCAGGGGTAAGATCTATTTTGGGTGCTGTTAATTTTATTAGTACTCTAGGTAATCTGCGAGTATTTGGTATATTGCTAGACCAGATACCATTGTTTGCTTGATCCGTACTAGTTACAGCTATTCTTTTACTCTTTTCTTTACCAGTTTTAGCTGGAGCTGGTTCTTTGGTCACCCTGAAGT
ASV556	GGTACTGGATGAACAGTTTATCCCCCTCTTTCAAGAAATATTGCCCATGCTGGTGGCTCTGTGGACTTTGCCATTTTTTCTTTACACCTCGCAGGGGTAAGATCTATTTTAGGTGCTGTTAATTTTATTAGTACTCTAGGTAATCTGCGAGTATTTGGTATATTGCTAGACCAGATACCATTGTTTGCTTGATCCGTACTAGTTACAGCTATTCTTTTACTCCTTTCTTTACCAGTTTTAGCTGGGGGTGGGAATCCTATCTTATACCAAATTTTTTTTTGATTCTTTGGTCACCCTGAAGT
ASV557	GGTACAGGATGAACTGTTTATCCCCCTCTCACGTTGACGAGAGTGTCTGGATGTTTGTGCTTCCATTGAAACCTTCATGAATATGGCCCATAGCCACCAGGATCACTTTTTGGGTGTATCAAGGTCTGCGCAAGCACCAGGAAGTGAGTTCCACCCCCGTGACAAAAGTGACAAAGTTGGTTGTGGTTCTTTGGTCACCCTGAAGT
ASV558	GGTACAGGTTGAACAGTATATCCTCCTCTTTCAAGAAATATTGCCCATGCTGGTGGCTCTGTGGACTTTGCTATTTTTTCTTTACATCTCGCAGGGGTAAGATCTATTTTAGGTGCTGTTAATTTTATTAGTACTCTAGGTAATCTGCGAGTATTTGGTATATTGCTAGACCAGATACCATTGTTTGCTTGATCCGTACTAGTTACAGCTATTCTTTTACTCCTTTCTTTACCAGTTTTAGCTGGAGCTATTACTATATTATTGACGGATCCTATCTTATATCAACATCTTTTTTGATTTTTTGGTCACCCTGAAGT
ASV559	GGTACTGGTTGAACTGTTTATCCCCCTCTTTCAAGAAATATTGCCCATGCTGGTGGCTCTGTGGACTTTGCCATTTTTTCTTTACACCTCGCAGGGGTAAGATCTATTTTAGGTGCTGTTAATTTTATTAGTACTCTAGGTAATCTGCGAGTATTTGGTATATTGCTAGACCAGATACCATTGTTTGCTTGATCCGTACTAGTTACAGCTATTCTTTTACTCCTTTCTTTACCAGTTTTAGCTGGAGCTATTACTATATTATTGACGGATCCTATCTTATATCAACATCTTTTTTGATTTTTTGGTCACCCTGAAGT
ASV560	GGAACAGGATGAACAGTATATCCCCCTCTTTCAAGAAATATTGCCCATGCTGGTGGCTCTGTGGACTTTGCTATTTTTTCTTTACATCTCGCAGGGGTAAGATCTATTTTAGGTGCTGTTAATTTTATTAGTACTCTAGGTAATCTGCGAGTATTTGGTATATTGCTAGACCAGATACCATTGTTTGCTTGATCCGTACTAGTTACAGCTATTCTTTTACTCCTTTCTTTACCAGTTTTAGCTGGAGCTATTACTATATTATTGACGGATCCTATCTTATATCAACATCTTTTTTGATTTTTTGGTCACCCTGAAGT
ASV561	GGTACTGGTTGAACAGTTTATCCTCCCTCAGCAGATAAAAAAATTATGTATGTTTATCAAGTAAAAATGTATTCCCCACCTTCATAACGTGTCCAATGTACTTATTATTATCGAGGGAGGGTGAAGAATATTAAACCAATCAATTTTGTTTGTTAACTAGAACTATAATTATTCCATGACATATTCTTATTATTTGTCCATTAGTCCTGACACACGTCAACTGATATGATTTTTTGGTCACCCTGAAGT
ASV562	GGTACTGGTTGAACAGTTTATCCCCCTCTTTCAAGAAATATTGCCCATGCTGGTGGCTCTGTGGACTTTGCTATTTTTTCTTTACATCTCGCAGGGGTAAGATCTATTTTAGGTGCTGTTAATTTTATTAGTACTCTAGGTAATCTGCGAGTATTTGGTATATTGCTAGACCAGATACCATTGTTTGCTTGATCCGTACTAGTTACAGCTATTCTTTTACTCCTTTCTTTACCAGTTTTAGCTGGAGCTATTACTATATTATTGACGGATCCTATCTTATATCAACATCTTTTTTGATTTTTTGGTCACCCTGAAGT
ASV563	GGTACTGGATGAACTGTTTACCCTCCCTGTTGAAATTTAAGGTTAATGAAATTTCATTCTTCTTCCGATCACATGTTTATATCACAGCCATTCAATTCAGATTTCACCTTGAACATTTCCATACTATTTAAAGAAAAAAAATTATATATCTGCACCTTAATTAGATTATGATTTTTTGGTCACCCTGAAGT
ASV564	GGAACTGGATGAACAGTTTACCCTCCTTTCTAGAAAGGATCTGTAGATTTTGCAATTTTTTCTCTTCATTTGGCAGGTGTCAGATCTATTTTAGGTGCTGTAAATTTTATTAGCACTTTAGGTAACTTACGAGTATTTGGTATATTATTGGACCGGGTACCATTGTTTGCCTGGTCGGTATTAATCACCGGTATTGGCAGGAGCTATTACTATATTATTGACAGATTGAAATTTAAATACAACTTTTTATGATGTAGGTGGAGGTGGAGATCCTATTTTATACCAACATTTATTTTGGTTCTTTGGTCACCCTGAAGT
ASV565	GGAACAGGTTGAACTGTTTATCCTCCCCTTTCTAGAAATATTGCACATGCAGGAGGATCTGTAGATTTTGCAATTTTTTCTCTTCATTTGGCAGGTGTCAGATCTATTTTAGGTGCTGTAAATTTTATTAGCACTTTAGGTAACTTACGAGTATTTGGTATATTATTGGACCGGGTACCATTGTTTGCCTGGTCGGTATTAATCACCGCAGTTCTTCTGCTATTATCTTTACCGGTATTGGCAGGAGGTGGAGATCCCATTTTATATCAACACTTATTTTGATTCTTTGGTCACCCTGAAGT
ASV566	GGTACTGGATGAACTGTTTACCCTCCCCTCTCTAGAAATATTGCACATGCAGGAGGATCTGTAGATTTTGCAATTTTTTCTCTTCATTTGGCAGGTGTTAGATCTATTTTAGGTGCTGTGAATTTTATTAGCACTTTAGGTAATTTACGAGTATTTGGTATATTATTGGATCGGGTACCATTATTTGCCAGATCGAAATTTAAATACAACTTTTTATGATGTAGGCGGAGGTGGAGACCCCATTTTATATCAACATTTATTTTGATTCTTTGGTCACCCTGAAGT
ASV567	GGTACAGGTTGAACAGTATATCCTCCCCCCCTATCTAGAAATATTGCACATGCAGGAGGGTCTGTAGATTTTGCAATTTTTTGCAAGTATTTGGTATATTATTGGATCGGGTACCATTATTTGCCTGGTCAGTATTAATCACCGCGGTTCTTCTACTATTATCTTTACCAGTATTGGCAGGAGCTATTACTATATTACTAACAGATCGAAATTTAAATACAACTTTTTATGATGTAGGCGGAGGTGGAGATCCCATTTTATATCAACATTTATTTTGATTTTTTGGTCACCCTGAAGT
ASV568	GGTACAGGTTGAACTGTATATCCTCCTCTCTCTAGAAATATTGCACATGCGGGAGGATCTGTAGATTTTGCAATTTTTTCTCTTCATTTGGCAGGTGTTAGATCTATTTTAGGTGCTGTGAATTTTATTAGCACTTTAGGTAATTTACGAGTATTTGGTATATTATTGGATCGGGTACCATTATTTGCCAGATCGAAATTTAAATACAACTTTTTATGATGTAGGCGGAGGTGGAGACCCCATTTTATATCAACATTTATTTTGATTCTTTGGTCACCCTGAAGT
ASV569	GGAACTGGTTGAACAGTTTATCCCCCGTGGACCTGTCGGCCAACCCTAGGGTGAGGCTAGCCATGCCCTCCCCCACCGCCTCCCCGGCGCCGGGCAGGAAGGCCAGGAAGAAGAGAGTGAGGTCCCAGGAGTCACCAAACCTCTCCCCCGACCCCAAGGCCAGCAGGACACAGTTGGTTCTTTGGTCACCCTGAAGT
ASV570	GGTACAGGTTGAACAGTATATCCTCCCCGATTTTCCCAGAATTAAGAAAGACTATGTATATAAGGTTTACTAGGAAACCCGCTTCGCGGGTTTGCCTAGGTGCTAACGCACAACTGCTTGGGACCAAGTCTGGCAAGTGCCTGGCTGGTTTTTGTGACCCCTGAGACATATTCAACAACTTTTGTTAACGAAATTTTTTGATTTGATGAAATTTTTTGACCTCCCCAGGGGCCTCCCCAAATGCGCCTGGACCCTCAGGGGTCAGAAGGTGACCCTGAATGATTCTTTGGTCACCCTGAAGT
ASV571	GGTACAGGTTGAACAGTTTACCCTCCTCTCTCAAGAAATATTGCCCATGCTGGTGGCTCTGTGGACTTTGCTATTTTTTCTTTACACCTCGCAGGGGTAAGATCTATTTTAGGTGCCGTTAATTTTATTAGTACTCTAGGTAATCTGCGAGTATTTGGTATATTACTAGACCAGATACCATTGTTTGCTTGATCCGTACTAGTAACAGCTATTCTTTTACTACTATCTTTACCAGTTTTAGCTGGAGCTATCACTATATTATTGACTGACCGAAACCTAAACACATCTTTTTTGATTCTTTGGTCACCCTGAAGT
ASV572	GGTACTGGTTGAACTGTTTATCCTCCTGGCAAGGAATGTGGCGCATGCCGGGAGCTCTGTAGACTTCGCCATTTTTTCGCTTCATTTGGCAGGGGTCTCTTCAATCTTAGGGGCAATTAACTTTATTAGAACCCTGGGTAATCTCCGGGTGTTTGGAATATTCTTAGACCGGATGCCTTTGTTCGCATGAGCTGTCTTAATCACAACTATTTTACTACTTCTTTCCCTTCCTGATTTTTTGGTCACCCTGAAGT
ASV573	GGAACAGGTTGAACTGTTTATCCCCCGATGAAATAAAATTTAATAAAAAACAGGTTTTAAATGGACGCAACTTTTTTTCAACTTTTTATGCCAAAAAATTAAGCTAGAATAAAAAGTAAGGTGTCTTTTGATATCTACGTAAAATTTCTGGTTTTTTGGTCACCCTGAAGT
ASV574	GGTACAGGTTGAACAGTATATCCTCCAAAGACCCTCTCTTCACCCTCTACCCCTATTGGAATACACAAACAATGGAAGGATATACTTTGAGATTAAATGGCTGGGGGCTCCTCTGCCATACATGTTTCAACATACCTCTCTGAGAGCATATCTAGTTTGATGTCATTAATGGTTCTTTGGTCACCTGAAGT
ASV575	GGTACTGGATGAACTGTATATCCCCCTTTTGAAAAAACCCAAACAGAAACAGATTTTTTTCTTCGGATGGCTTCCCTAAGCAGGCCCCTTTTGTGCATTATATATAGGGAAAATAGATATTGGGCAAGTTTTGCCTTATGCATTTAATATTGAATTTTGCTGCATCCCGCTTGCTGCTGAAATTAAAGTTTAGTGGTTTTTTGGTCACCCTGAAGT
ASV576	GGTAACTGGTTGAACAGTTTATCCCCCCTACAATTCCCGAATTTGGTTGTCTTGTCTATAGGGTCCCTATGAAAGATTACGCCAACCTATAAGGGCCCTTGCAATGGGTCCCAGCCCTGCCATTAACACTCAATAAAAGAACAAACAGTGCTAAGTCTCCGATTCTCCCAGTTTGGTGGCAACTGTCCCAATTAAGGCAGATAGAGACTGTTGGTCCTTGATTCTTTGGTCACCCTGAAGT
ASV577	GGTACAGGATGAACTGTTTACCCTCCAGTGGTTCCATCCAGTGGAAAGGTGTTACACATTTCAGTGCTGTCCCAGAACGAACCTGCGTTGATGATTTCTTTGGCATGTGAATTCCTCAGTTCCTCCTCACTCCTTGGCTTGTAATTGATTGGAGTATAATGCCTATTGAGATTATTTGGTTGTGTTGGAGAAAACACCGTGTCGTCATTGTCATTGTTGGGATAGTTGTTGGGGTCGTCGTGATTCTTTGGTCACCCTGAAGT
ASV578	GGGAGTGGCACCTTCCAGGGTCAAGGAAGGCACGGGGGAGGGGCAAACAACAGATGGCTGGCAACTAGAAGGCACAGTCGAGGCTGATCAGCGGGTTTAAACGGGCCCTCTAGACTCGAGCTATCAAGAACATTCGGCGGGGGCCAGAGATTTTTCGACGGTGTGCCCTTCGTGGGTGACCTGACAGGTCACGG
ASV579	GGATCCGAGCTCGGTACCAAGCTTAAGTTTAAACGCTAGCCAGCTTGGGTCTCCCTATAGTGAGTCGTATTAATTTCGATAAGCCAGTAAGCAGTGGGTTCTCTAGTTAGCCAGAGAGCTCTGCTTATATAGACCTCCCACCGTACACGCCTACCGCCCATTTGCGTCAATGGGGCGGAGTTGTTACGACATTTTGGAAAGTCCCGTTGATTTTGGTGCCAAAACAAACTCCCATTGACGTCAATGGGGTGGAGACTTGGAAATCCCCGTGAGTCAAACCGCTATCCACGCCCATTGATGTACTGCCAAAACCGCA
ASV580	GGAACTGGATGAACAGTATATCCCCCACAGTGCAAAACATTTGTCACCTATTTTCCACTGCATTGTTTGTAAACTTTGCTACACCACTAAGATTAATTACTTTTCTGTTTTCTGTCTGTTTTCTTTCTGTTGAAGTGTTTGCGTTTCGCCCGAATCTATAGAGCAAGACACTCTTTTTACTTCCTTCAATTACATACTTGAGTTTAGTTCTGTTCTGGGTTTGCTGATTTTTTGGTCACCCTGAAGT
ASV581	GATCCGAGGTGTACCAGTCCGGGCCAGACTATTTTTTCCAGACCAGTAGACAAGGCCTGCAGACCGTAAACCTGAGCCAGGCTTTCAAGAACTTGCAGGGGCTGTGGGGGGTGCGGGCTCCCACAGGCGACCGCGCGACCGTGTCTAGCTTGCTGACGCCCAACTCGCGCCTGTTGCTGCTGCTAATAGCGCCCTTCACGGACAGTGGCAGCGTGTCCCGGGACACATACCTAGGTCACTTGCTGACACTGTACCGCGAGGCCATAGGTCAGGCGCATGTGGACGAGCATACTTTCCAGGAGATTACAAGT
ASV582	CTGACGAGCATCACAAAAATCGACGCTCAAGTCAGAGGTGGCGAAACCCGACAGGACTATAAAGATACCAGGCGTTTCCCCCTGGAAGCTCCCTCGTGCGCTCTCCTGTTCCGACCCTGCCGCTTACCGGATACCTGTCCGCCTTTCTCCCTTCGGGAAGCGTGGCGCTTTCTCATAGCTCACGCTGTAGGTATCTCAGTTCGGTGTAGGTCGTTCGCTCCAAGCTGGGCTGTGTGCACGAACCCCCCGTTCAGCCCGACCGCTGCGCCTTATCCGGTAACTATCGTCTTGAGTCCAACCCGGTAAGACAC
ASV583	GGAACAGGTTGAACAGTATACCCCCCTCTTTTGTCCTTCCGAGAGAGAATCACGGCTTCATTTCCTTAGCACTCTCACGAGGATCGTACTAGGTCGGGGCGTCCTTCGATTCCTGGAGTTACGATGCATTTGGAGCGACGGCATCGCTGCAAGACGGCGTGGTGACGTGACGCTGATATCACTGAACGACTTGTTTTATGGAATCGAGTGATTCTTTGGTCACCCTGAAGT
ASV584	GGTACAGGATGAACAGTATACCCCCCTCTGAGTTCTTATATTTTTCACGGGGGAGCATCGGTTGACTTTACAATTTTTAGACTTCACCTAGCCGGAGTTTCTTCTCTCCTAGGGGCTGTAAACTTTATTAGCACGGTTTTAAATTTACGGGCATTAGGTATGTTGATAGATCGCATACCTTTATTCCCATGGGCAGTATTTATTACTGCTATTCTGGTTTTTTGGTCACCCTGAAGT
ASV585	GGTACTGGATGAACTGTTTATCCCCCTCTTTCAAGAAATATTGCCCATGCTGGTGGCTCTGTGGACTTTGCCATTTTTTCTTTACACCTCGCAGGGGTAAGATCTATTTTAGGTGCTGTTAATTTTATTAGTACTCTAGGTAATCTGCGAGTATTTGGTATATTGCTAGACCAGATACCATTGTTTGCTTGATCCGTACTAGTTACAGCTATTCTTTTACTCCTTTCTTTACCAGTTTTAGCTGGAGCTATTACTATATTTTTGACGGACCGAAACATCTTTTTTGGTTCTTTGGTCACCCTGAAGT
ASV586	GGTACAGGTTGAACTGTTTACCCTCCTCTTTCAAGAAATATTGCCCATGCTGGTGGCTCTGTGGACTTTGCTATTTTTTCTTTACATCTCGCAGGGGTAAGATCTATTTTAGGTGCTGTTAATTTTATTAGTACTCTAGGTAATCTGCGAGTATTTGGTATATTGCTAGACCAGATACCATTGTTTGCTTGATCCGTGCTAGTAACAGGTGGGGACCCTATCTTATACCAACATCTTTTTTGGTTTTTTGGTCACCCTGAAGT
ASV587	GGTACTGGTTGAACTGTTTATCCCCCTCTTTCAAGAAATATTGCCCATGCTGGTGGCTCTGTGGACTTTGCCATTTTTTCTTTACACCTCGCAGGGGTAAGATCTATTTTAGGTGCTGTTAATTTTATTAGTACTCTAGGTAATCTGCGAGTATTTGGTATATTGCTAGACCAGATACCATTGTTTGCTTGATCCGTACTAGTTACAGCTATTCTTTTACTCCTTTCTTTACCAGTTTTAGCTGGAGCTATTACTATATTTTTGACGGACCGAAACATCTTTTTTGGTTCTTTGGTCACCCTGAAGT
ASV588	GGAACTGGTTGAACTGTTTATCCTCCTCTTTCAAGAAATATTGCCCATGCTGGTGGCTCTGTGGACTTTGCTATTTTTTCTTTACATCTCGCAGGGGTAAGATCTATTTTAGGTGCTGTTAATTTTATTAGTACTCTAGGTAATCTGCGAGTATTTGGTATATTGCTAGACCAGATACCATTGTTTGCTTGATCCGTGCTAGTAACAGGTGGGGACCCTATCTTATACCAACATCTTTTTTGGTTTTTTGGTCACCCTGAAGT
ASV589	GGTACAGGTTGAACTGTTTACCCTCCTCTTTCAAGAAATATTGCCCATGCTGGTGGCTCTGTGGACTTTGCTATTTTTTCTTTACATCTCGCAGGGGTAAGATCTATTTTAGGTGCTGTTAATTTTATTAGTACTCTAGGTAATCTGCGAGTATTTGGTATATTGCTAGACCAGATACCATTGTTTGCTTGATCCGTACTAGTTACAGCTATTCTTTTACTCCTTTCTTTACCAGTTTTAGCTGGAGCTATTACTATATTTTTGACGGACCGAAACATCTTTTTTGGTTCTTTGGTCACCCTGAAGT
ASV590	GGTACTGGTTGAACAGTATACCCTCCTCTTTCAAGAAATATTGCCCATGCTGGTGGCTCTGTGGACTTTGCTATTTTTTCTTTACATCTCGCAGGGGTAAGATCTATTTTAGGTGCTGTTAATTTTATTAGTACTCTAGGTAATCTGCGAGTATTTGGTATATTGCTAGACCAGATACCATTGTTTGCTTGATCCGTGCTAGTAACAGGTGGGGACCCTATCTTATACCAACATCTTTTTTGGTTTTTTGGTCACCCTGAAGT
ASV591	GGAACAGGATGAACTGTTTACCCTCCTCTGAGTTCTTATATTTTTCACGGGGGAGCATCGGTTGACTTTACAATTTTTAGACTTCACCTAGCCGGAGTTTCTTCTCTCCTAGGGGCTGTAAACTTTATTAGCACGGTTTTAAATTTACGGGCATTAGGTATGTTGATAGATCGCATACCTTTATTCCCATGGGCAGTATTTATTACTGCTATTCTGATTTTTTGGTCACCCTGAAGT
ASV592	GGAACAGGATGAACTGTATATCCTCCTCTGAGTTCTTATATTTTTCACGGGGGAGCATCGGTTGACTTTACAATTTTTAGACTTCACCTAGCCGGAGTTTCTTCTCTCCTAGGGGCTGTAAACTTTATTAGCACGGTTTTAAATTTACGGGCATTAGGTATGTTGATAGATCGCATACCTTTATTCCCATGGGCAGTATTTATTACTGCTATTCTGATTTTTTGGTCACCCTGAAGT
ASV593	GGAACTGGTTGAACTGTTTACCCCCCTCTTTCAAGAAATATTGCCCATGCTGGTGGCTCTGTGGACTTTGCTATTTTTTCTTTACATCTCGCAGGGGTAAGATCTATTTTAGGTGCTGTTAATTTTATTAGTACTCTAGGTAATCTGCGAGTATTTGGTATATTGCTAGACCAGATACCATTGTTTGCTTGATCCGTACTAGTTACAGCTATTCTTTTACTCCTTTCTTTACCAGTTTTAGCTGGAGCTAATATCAACATCTTTTTTGGTTTTTTGGTCACCCTGAAGT
ASV594	GGTACTGGTTGAACAGTATATCCCCCTCTTTCAAGAAATATTGCCCATGCTGGTGGCTCTGTGGACTTTGCTATTTTTTCTTTACATCTCGCAGGGGTAAGATCTATTTTAGGTGCTGTTAATTTTATTAGTACTCTAGGTAATCTGCGAGTATTTGGTATATTGCTAGACCAGATACCATTGTTTGCTTGATCCGTACTAGTTACAGCTATTCTTTTACTCCTTTCTTTACCAGTTTTAGCTGGAGCTAATATCAACATCTTTTTTGGTTTTTTGGTCACCCTGAAGT
ASV595	GGTACTGGTTGAACTGTATATCCTCCTCTTTCAAGAAATATTGCCCATGCTGGTGGCTCTGTGGACTTTGCTATTTTTTCTTTACATCTCGCAGGGGTAAGATCTATTTTAGGTGCTGTTAATTTTATTAGTACTCTAGGTAATCTGCGAGTATTTGGTATATTGCTAGACCAGATACCATTGTTTGCTTGATCCGTACTAGTTACAGCTATTCTTTTACTCCTTTCTTTACCAGTTTTAGCTGGAGCTAATATCAACATCTTTTTTGGTTTTTTGGTCACCCTGAAGT
ASV596	GGTACTGGATGAACTGTATATCCTCCTCTAAGTCATATTACGAGCCACTCTGGTGGTGCAGTTGATTTAGCTATTTTCAGTTTACATTTATCTGGAGCGAGCAGTATTTTAGGGGCGATTAACTTTATTACCACTATCTTTAACATGCGTGGGCCTGGTCTGGGCTTCCATCGCTTACCTTGGTTCTTTGGTCACCCTGAAGT
ASV597	GGAACAGGATGAACAGTTTATCCCCCTCTAAGTCATATTACGAGCCACTCTGGTGGTGCAGTTGATTTAGCTATTTTCAGTTTACATTTATCTGGAGCGAGCAGTATTTTAGGGGCGATTAACTTTATTACCACTATCTTTAACATGCGTGGGCCTGGTCTGGGCTTCCATCGCTTACCTTGGTTCTTTGGTCACCCTGAAGT
ASV598	GGAACTGGATGAACTGTTTATCCTCCTCTAAGTCATATTACGAGCCACTCTGGTGGTGCAGTTGATTTAGCTATTTTCAGTTTACATTTATCTGGAGCGAGCAGTATTTTAGGGGCGATTAACTTTATTACCACTATCTTTAACATGCGTGGGCCTGGTCTGGGCTTCCATCGCTTACCTTGGTTCTTTGGTCACCCTGAAGT
ASV599	GGTACAGGATGAACAGTATACCCCCCTCTAAGTCATATTACGAGCCACTCTGGTGGTGCAGTTGATTTAGCTATTTTCAGTTTACATTTATCTGGAGCGAGCAGTATTTTAGGGGCGATTAACTTTATTACCACTATCTTTAACATGCGTGGGCCTGGTCTGGGCTTCCATCGCTTACCTTGGTTCTTTGGTCACCCTGAAGT
ASV600	GGAACAGGTTGAACAGTTTACCCCCCTCTAAGTCATATTACGAGCCACTCTGGTGGTGCAGTTGATTTAGCTATTTTCAGTTTACATTTATCTGGAGCGAGCAGTATTTTAGGGGCGATTAACTTTATTACCACTATCTTTAACATGCGTGGGCCTGGTCTGGGCTTCCATCGCTTACCTTGGTTCTTTGGTCACCCTGAAGT
ASV601	GGTACTGGATGAACTGTTTACCCCCCTCTAAGTCATATTACGAGCCACTCTGGTGGTGCAGTTGATTTAGCTATTTTCAGTTTACATTTATCTGGAGCGAGCAGTATTTTAGGGGCGATTAACTTTATTACCACTATCTTTAACATGCGTGGGCCTGGTCTGGGCTTCCATCGCTTACCTTGGTTCTTTGGTCACCCTGAAGT
ASV602	GGTACTGGTTGAACAGTTTACCCTCCTCTAAGTCATATTACGAGCCACTCTGGTGGTGCAGTTGATTTAGCTATTTTCAGTTTACATTTATCTGGAGCGAGCAGTATTTTAGGGGCGATTAACTTTATTACCACTATCTTTAACATGCGTGGGCCTGGTCTGGGCTTCCATCGCTTACCTTGGTTCTTTGGTCACCCTGAAGT
ASV603	GGAACAGGTTGAACTGTATACCCCCCTCTAAGTCATATTACGAGCCACTCTGGTGGTGCAGTTGATTTAGCTATTTTCAGTTTACATTTATCTGGAGCGAGCAGTATTTTAGGGGCGATTAACTTTATTACCACTATCTTTAACATGCGTGGGCCTGGTCTGGGCTTCCATCGCTTACCTTGGTTCTTTGGTCACCCTGAAGT
ASV604	GGTACTGGTTGAACTGTTTATCCTCCTCTAAGTCATATTACGAGCCACTCTGGTGGTGCAGTTGATTTAGCTATTTTCAGTTTACATTTATCTGGAGCGAGCAGTATTTTAGGGGCGATTAACTTTATTACCACTATCTTTAACATGCGTGGGCCTGGTCTGGGCTTCCATCGCTTACCTTGGTTCTTTGGTCACCCTGAAGT
ASV605	GGTACAGGATGAACTGTTTATCCTCCTCTAAGTCATATTACGAGCCACTCTGGTGGTGCAGTTGATTTAGCTATTTTCAGTTTACATTTATCTGGAGCGAGCAGTATTTTAGGGGCGATTAACTTTATTACCACTATCTTTAACATGCGTGGGCCTGGTCTGGGCTTCCATCGCTTACCTTGGTTCTTTGGTCACCCTGAAGT
ASV606	GGTACTGGATGAACAGTATACCCTCCTCTTTCAAGAAATATTGCCCATGCTGGTGGCTCTGTGGACTTTGCTATTTTTTCTTTACATCTCGCAGGGGTAAGATCTATTTTAGGTGCTGTTAATTTTATTAGTACTCTAGGTAATCTGCGAGTATTTGGTATATTGCTAGACCAGATACCATTGTTTGCTTGATCCGTACTAGTTACAGCTATTCTTTTACTCCTTTCTTTACCAGTTTTAGCTGGGGGTGGGAATCCTATCTTATACCAAATTTTTTTTTGATTCTTTGGTCACCCTGAAGT
ASV607	GGTACTGGTTGAACAGTATACCCTCCTCTTTCAAGAAATATTGCCCATGCTGGTGGCTCTGTGGACTTTGCTATTTTTTCTTTACATCTCGCAGGGGTAAGATCTATTTTAGGTGCTGTTAATTTTATTAGTACTCTAGGTAATCTGCGAGTATTTGGTATATTGCTAGACCAGATACCATTGTTTGCTTGATCCGTACTAGTTACAGCTATTCTTTTACTCCTTTCTTTACCAGTTTTAGCTGGGGGTGGGAATCCTATCTTATACCAAATTTTTTTTTGATTCTTTGGTCACCCTGAAGT
ASV608	GGTACTGGTTGAACAGTATATCCCCCTCTTTCAAGAAATATTGCCCATGCTGGTGGCTCTGTGGACTTTGCTATTTTTTCTTTACATCTCGCAGGGGTAAGATCTATTTTAGGTGCTGTTAATTTTATTAGTACTCTAGGTAATCTGCGAGTATTTGGTATATTGCTAGACCAGATACCATTGTTTGCTTGATCCGTACTAGTTACAGCTATTCTTTTACTCCTTTCTTTACCAGTTTTAGCTGGGGGTGGGAATCCTATCTTATACCAAATTTTTTTTTGATTCTTTGGTCACCCTGAAGT
ASV609	GGAACTGGTTGAACTGTTTATCCCCCCTCTTTCAAGAAATATTGCCAATGCTGGGGGCTCTGTAGATTTTGCAATTTTTTCTTTGCATCTTGCAGGAGTAAGATCTATCGTAGGTGCTGTAAATTTTATTAGTACTCTAGGTAATCTACGAGTATTTGGTATATTACTGGATCAGATACCATTATTTGCTTGATCCGTATACTGTCTTTACCAGTTTTAGCTGGAGCTAAACACCTCTTTTTATGATGTAGGTGGGGGTGGAGATCCTATCATATACCAACATATTTTTTTTGATTCTTTGGTCACCCTGAAGT
ASV610	GGAACTGGTTGAACAGTATATCCTCCTCTTTCAAGAAATATTGCCCATGCTGGTGGCTCTGTGGACTTTGCTATTTTTTCTTTACATCTCGCAGGGGTAAGATCTATTTTAGGTGCTGTTAATTTTATTAGTACTCTAGGTAATCTGCGAGTATTTGGTATATTGCTAGACCAGATACCATTGTTTGCTTGATCCGTACTAGTTACAGCTATTCTTTTACTCCTTTCTTTACCAGTTTTAGCTGGGGGTGGGAATCCTATCTTATACCAAATTTTTTTTTGATTCTTTGGTCACCCTGAAGT
ASV611	GGTACTGGTTGAACTGTATATCCTCCTCTTTCAAGAAATATTGCCCATGCTGGTGGCTCTGTGGACTTTGCTATTTTTTCTTTACACCTCGCAGGGGTAAGATCTATTTTAGGTGCCGTTAATTTTATTAGTACTCTAGGTAATCTGCGAGTATTTGGTATATTGCTAGACCAGATACCATTGTTTGCTTGATCCGTACTAGTTACAGCTATTCTTTTACTCCTTTCTTTACCAGTTTTAGCTGGGGGTGGGAATCCTATCTTATACCAAATTTTTTTTTGATTCTTTGGTCACCCTGAAGT
ASV612	GGTACAGGTTGAACTGTTTATCCTCCTCTTTCAAGAAATATTGCCCATGCTGGTGGCTCTGTGGACTTTGCTATTTTTTCTTTACATCTCGCAGGGGTAAGATCTATTTTGGGTGCTGTTAATTTTATTAGTACTCTAGGTAATCTGCGAGTATTTGGTATATTGCTAGACCAGATACCATTGTTTGCTTGATCCGTACTAGTTACAGCTATTCTTTTACTCCTTTCTTTACCAGTTTTAGCTGGGGGTGGGAATCCTATCTTATACCAAATTTTTTTTTGATTCTTTGGTCACCCTGAAGT
ASV613	GGAACTGGTTGAACAGTTTATCCTCCTCTTTCAAGAAATATTGCCCATGCTGGTGGCTCTGTGGACTTTGCTATTTTTTCTTTACATCTCGCAGGGGTAAGATCTATTTTAGGTGCTGTTAATTTTATTAGTACTCTAGGTAATCTGCGAGTATTTGGTATATTGCTAGACCAGATACCATTGTTTGCTTGATCCGTACTAGTTACAGCTATTCTTTTACTCCTTTCTTTACCAGTTTTAGCTGGAGCTATTACTATATTATTGACGGATCCTATCTTATATCAACATCTTTTTTGATTTTTTGGTCACCCTGAAGT
ASV614	GGTACTGGTTGAACAGTATACCCCCCTCTTTCAAGAAATATTGCCCATGCTGGTGGCTCTGTGGACTTTGCTATTTTTTCTTTACATCTCGCAGGGGTAAGATCTATTTTAGGTGCTGTTAATTTTATTAGTACTCTAGGTAATCTGCGAGTATTTGGTATATTGCTAGACCAGATACCATTGTTTGCTTGATCCGTACTAGTTACAGCTATTCTTTTACTCCTTTCTTTACCAGTTTTAGCTGGAGCTATTACTATATTATTGACGGATCCTATCTTATATCAACATCTTTTTTGATTTTTTGGTCACCCTGAAGT
ASV615	GGAACTGGTTGAACTGTATATCCTCCTCTTTCAAGAAATATTGCCCATGCTGGTGGCTCTGTGGACTTTGCTATTTTTTCTTTACATCTCGCAGGGGTAAGATCTATTTTAGGTGCTGTTAATTTTATTAGTACTCTAGGTAATCTGCGAGTATTTGGTATATTGCTAGACCAGATACCATTGTTTGCTTGATCCGTACTAGTTACAGCTATTCTTTTACTCCTTTCTTTACCAGTTTTAGCTGGAGCTATTACTATATTATTGACGGATCCTATCTTATATCAACATCTTTTTTGATTTTTTGGTCACCCTGAAGT
ASV616	GGAACAGGATGAACAGTTTACCCTCCTCTTTCAAGAAATATTGCCCATGCTGGTGGCTCTGTGGACTTTGCTATTTTTTCTTTACATCTCGCAGGGGTAAGATCTATTTTAGGTGCTGTTAATTTTATTAGTACTCTAGGTAATCTGCGAGTATTTGGTATATTGCTAGACCAGATACCATTGTTTGCTTGATCCGTACTAGTTACAGCTATTCTTTTACTCCTTTCTTTACCAGTTTTAGCTGGAGCTATTACTATATTATTGACGGATCCTATCTTATATCAACATCTTTTTTGATTTTTTGGTCACCCTGAAGT
ASV617	GGTACAGGTTGAACAGTATATCCTCCCCCCCTATCTAGAAATATTGCACATGCAGGAGGGTCTGTAGATTTTGCAATTTTTTGCAAGTATTTGGTATATTATTGGATCGGGTACCATTATTTGCCTGGTCAGTATTAATCACCGCGGTTCTTCTACTATTATCTTTACCAGTATTGGCAGGAGCTATTACTATATTACTAACAGATCGAAATTTAAATACAACTTTTTATGATGTGGGCGGAGGTGGAGATCCCATTTTATATCAACATTTATTTTGGTTCTTTGGTCACCCTGAAGT
ASV618	GGTACAGGTTGAACAGTATATCCTCCCCCCCTATCTAGAAATATTGCACATGCAGGAGGGTCTGTAGATTTTGCAATTTTTTGCAAGTATTTGGTATATTATTGGATCGGGTACCATTATTTGCCTGGTCAGTATTAATCACCGCGGTTCTTCTACTATTATCTTTACCAGTATTGGCAGGAGCTATTACTATATTACTAACAGATCGAAATTTAAATACAACTTTTTATGATGTAGGCGGAGGTGGAGATCCCATTTTATATCAACATTTATTTTGGTTTTTTGGTCACCCTGAAGT
ASV619	GGTACTGGTTGAACTGTTTATCCTCCCCTCTCTAGAAATATTGCACATGCAGGAGGATCTGTAGATTTTGCAATTTTTTCTCTTCATTTGGCAGGTGTTAGATCTATTTTAGGTGCTGTGAATTTTATTAGCACTTTAGGTAACTTACGAGTATTTGGTATATTATTGGACCGGGTACCATTGTTTGCCTGGTCGGTATTAATCACCGCAGTTCTTCTGCTATTATCTTTACCGGTATTGGCAGGAGGTGGAGATCCCATTTTATATCAACACTTATTTTGATTCTTTGGTCACCCTGAAGT
ASV620	GGTACAGGATGAACTGTATACCCCCCTCTCTCTAGAAATATTGCACATGCGGGAGGATCTGTAGATTTTGCAATTTTTTCTCTTCATTTGGCAGGTGTTAGATCTATTTTAGGTGCTGTTAATTTTATTAGCACTTTAGGTAATTTACGAGTATTTGGTATATTATTGGATCGGGTACCATTATTTGCCAGATCGAAATTTAAATACAACTTTTTATGATGTAGGCGGAGGTGGAGACCCCATTTTATATCAACATTTATTTTGATTCTTTGGTCACCCTGAAGT
ASV621	GGTACAGGATGAACAGTATACCCCCCTCTTTCAAGAAATATTGCCCATGCTGGTGGCTCTGTGGACTTTGCTATTTTTTCTCTTCATTTGGCAGATGTTAGATCTATTTTAGGTGCTGTTAATTTTATTAGCACTTTAGGTAATTTACGAGTATTTGGTATATTATTGGATCGGGTACCATTATTTGCCAGATCGAAATTTAAATACAACTTTTTATGATGTAGGCGGAGGTGGAGACCCCATTTTATATCAACATTTATTTTGATTCTTTGGTCACCCTGAAGT
ASV622	GGTACTGGTTGAACTGTTTACCCTCCTCTCTCTAGAAATATTGCACATGCGGGAGGATCTGTAGATTTTGCAATTTTTTCTCTTCATTTGGCAGGTGTTAGATCTATTTTAGGTGCTGTGAATTTTATTAGCACTTTAGGTAATTTACGAGTATTTGGTATATTATTGGATCGGGTACCATTATTTGCCAGATCGAAATTTAAATACAACTTTTTATGATGTAGGCGGAGGTGGAGACCCCATTTTATATCAACATTTATTTTGATTCTTTGGTCACCCTGAAGT
ASV623	GGTACAGGTTGAACAGTATATCCTCCCCCCCTATCTAGAAATATTGCACATGCAGGAGGGTCTGTAGATTTTGCAATTTTTTGCAAGTATTTGGTATATTATTGGATCGGGTACCATTATTTGCCTGGTCAGTATTAATCACCGCGGTTCTTCTACTATTATCTTTACCAGTATTGGCAGGAGCTATTACTATATTACTAACAGATCGAAATTTAAATACAACTTTTTATGATGTGGGCGGAGGTGGAGATCCCATTTTATATCAACATTTATTTTGATTCTTTGGTCACCCTGAAGT
ASV624	GGAACTGGTTGAACTGTTTACCCTCCTCTTTCAAGAAATATTGCCCATGCTGGTGGCTCTGTGGACTTTGCTATTTTTTCTTTACATCTCGCAGGGGTAAGATCTATTTTAGGTGCTGTTAATTTTATTAGTACTCTAGGTAATCTGCGAGTATTTGGTATATTGCTAGACCAGATACCATTGTTTGCTTGATCCGTACTAGTTACAGCTATTCTTTTACTCCTTGTAAATTTAACCATGGTTATATCCTTTTCTTAGTTAGTTCAGTACATCTTTTTTGATTCTTTGGTCACCCTGAAGT
ASV625	GGAACTGGTTGAACTGTATACCCCCCCCTCTCTAGAAATATTGCACATGCGGGAGGATCTGTAGATTTTGCAATTTTTTCTCTTCATTTGGCAGGTGTTAGATCTATTTTAGGTGCTGTTAATTTTATTAGCACTTTAGGTAATTTACGAGTATTTGGTATATTATTGGATCGGGTACCATTATTTGCCAGATCGAAATTTAAATACAACTTTTTATGATGTAGGCGGAGGTGGAGACCCCATTTTATATCAACATTTATTTTGATTCTTTGGTCACCCTGAAGT
ASV626	GGTACTGGTTGAACAGTTTACCCCCCTCTTTCAAGAAATATTGCCCATGCTGGTGGCTCTGTGGACTTTGCTATTTTTTCTTTACATCTCGCAGGGGTAAGATCTATTTTAGGTGCTGTTAATTTTATTAGTACTCTAGGTAATCTGCGAGTATTTGGTATATTGCTAGACCAGATACCATTGTTTGCTTGATCCGTACTAGTTACAGCTATTCTTTTACTCCTTGTAAATTTAACCATGGTTATATCCTTTTCTTAGTTAGTTCAGTACATCTTTTTTGATTCTTTGGTCACCCTGAAGT
ASV627	GGTACAGGATGAACTGTATATCCTCCTCTTTCAAGAAATATTGCCCATGCTGGTGGCTCTGTGGACTTTGCTATTTTTTCTTTACATCTCGCAGGGGTAAGATCTATTTTAGGTGCTGTTAATTTTATTAGTACTCTAGGTAATCTGCGAGTATTTGGTATATTGCTAGACCAGATACCATTGTTTGCTTGATCCGTACTAGTTACAGCTATTCTTTTACTCCTTGTAAATTTAACCATGGTTATATCCTTTTCTTAGTTAGTTCAGTACATCTTTTTTGATTCTTTGGTCACCCTGAAGT
ASV628	GGTACAGGTTGAACTGTATATCCCCCTCTCTCTAGAAATATTGCACATGCGGGAGGATCTGTAGATTTTGCAATTTTTTCTCTTCATTTGGCAGGTGTTAGATCTATTTTAGGTGCTGTGAATTTTATTAGCACTTTAGGTAATTTACGAGTATTTGGTATATTATTGGATCGGGTACCATTATTTGCCAGATCGAAATTTAAATACAACTTTTTATGATGTAGGCGGAGGTGGAGACCCCATTTTATATCAACATTTATTTTGATTCTTTGGTCACCCTGAAGT
ASV629	GGTACTGGTTGAACTGTATATCCTCCTCTCTCTAGAAATATTGCACATGCGGGAGGATCTGTAGATTTTGCAATTTTTTCTCTTCATTTGGCAGGTGTTAGATCTATTTTAGGTGCTGTTAATTTTATTAGCACTTTAGGTAATTTACGAGTATTTGGTATATTATTGGATCGGGTACCATTATTTGCCAGATCGAAATTTAAATACAACTTTTTATGATGTAGGCGGAGGTGGAGACCCCATTTTATATCAACATTTATTTTGATTCTTTGGTCACCCTGAAGT
ASV630	GGAACTGGTTGAACAGTATATCCTCCCCTTTCTAGAAATATTGCACATGCAGGAGGATCTGTAGATTTTGCAATTTTTTCTCTTCATTTGGCAGGTGTCAGATCTATTTTAGGTGCTGTAAATTTTATTAGCACTTTAGGTAACTTACGAGTATTTGGTATATTATTGGACCGGGTACCATTGTTTGCCTGGTCGGTATTAATCACCGCAGTTCTTCTGCTATTATCTTTACCGGTATTGGCAGGAGGTGGAGATCCCATTTTATATCAACACTTATTTTGATTCTTTGGTCACCCTGAAGT
ASV631	GGAACTGGTTGAACAGTATATCCCCCTTTTCTAGAAATATTGCACATGCAGGAGGATCTGTGGATTTTGCAATTTTAGGTGCTGTAAATTTTATTAGCACTTTAGGTAACTTACGAGTATTTGGTATATTATTGTTTGCCTGGTCGGTATTAATCACCGCGGTTCTTCTACTATTATCTTTACCAGTATTGGCAGGAGCTATTACTATATTACTGACAGATCGAAATTTAAATACAACTTTTTATGATGTGGGCGGAGGTGGAGATCCCATTTTATATCAACATTTATTTTGATTCTTTGGTCACCCTGAAGT
ASV632	ACTTCGCCCAATAGCAGCCAGTCCCTTCCCGCTTCAGTGACAACGTCGAGCACAGCTGCGCAAGGAACGCCCGTCGTGGCCAGCCACGATAGCCGCGCTGCCTCGTCTTGCAGTTCATTCAGGGCACCGGACAGGTCGGTCTTGACAAAAAGAACCGGGCGCCCCTGCGCTGACAGCCGGAAC
ASV633	GAGCGTGTCCCTGACCTGCATGATCAACGGCTTCTACCCCAGCGACATCTCCGTGGAGTGGGAGAAGAACGGCAAGGCCGAGGACAACTACAAGACCACCCCAGCCGTGCTGGACAGCGACGGCTCCTACTTCCTGTACAACAAGCTGTCCGTGCCCACCAGCGAGTGGCAGCGGGGCGACGTGTTCACCTGCTCCGTGATGCACGAGGCCCTGCACAACCACTACACCCAGAAGAGCATCTCCAGGAGCCCCGGCAAGAGGGGAAGGAAGCGCCGGTCCGGCAGCGGAGCCACCAACTTCAGCCTGCTGAAGCAGG
ASV634	TCGCCGTCGGGCATGCTCGCCTTGAGCCTGGCGAACAGTTCGGCTGGCGCGAGCCCCTGATGCTCTTCGTCCAGATCATCCTGATCGACAAGACCGGCTTCCATCCGAGTACGTGCTCGCTCGATGCGATGTTTCGCTTGGTGGTCGAATGGGCAGGTAGCCGGATCAAGCGTATGCAGCCGCCGCATTGCATCAGCCATGATGGATACTTTCTCGGCAGGAGCAAGGTGAGATGACAGGAGATCCTGCCCCGGCACTTCGCCCAATAGCAGCCAGTCCCTTCCCGCTTCAGTGACAACGTC
ASV635	TCGGGCTGCAGGGAGCTGATGGTCAGGGTGAAGTCGGTTCCGGAGCCGCTGCCGGAGAACCGGCTGGGCACTCCGGACTGCAGGGTGCTGGCGGAGTAGATCAGCAGCTTGGGGGCCTTGCCGGGCTTCTGCTGGTACCAGCCCAGGTCGTTCCTGATGCCCTGGCTGGCCCTGCAGGTGATGGTCACCCTGTCGCCCACGCTGGCGGACAGGGAGCTGGGGGACTGGGTCATCTGGATGGCTCCGTAGGCTCCGCTGATCCACAGCAGCAGGGAGATGAACACCTGGGTCTGCAGCACCATTGGT
ASV636	GTGACCTGGAACTCCGGCACCCTGACCAACGGCGTGAGGACCTTCCCAAGCGTGCGCCAGTCCAGCGGACTGTACTCCCTGTCCAGCGTGGTGAGCGTGACCTCCAGCTCCCAGCCAGTGACCTGCAACGTGGCCCACCCAGCCACCAACACCAAGGTGGACAAGACCGTGGCCCCAAGCACCTGCTCCAAGCCAACCTGCCCTCCTCCCGAGCTGCTGGGCGGCCCCTCCGTGTTCATCTTCCCTCCCAAGCCCAAGGACACCCTGATGATCTCCAGGACCCCAGAGGTGACCTGCGTGGTGGTGGACGTGA
ASV637	AGCCAGCCGTGACCCCATCCGTGATCCTGTTCCCTCCCTCCTCCGAGGAGCTGAAGGACAACAAGGCCACCCTGGTGTGCCTGATCTCCGACTTCTACCCCCGCACCGTGAAGGTGAACTGGAAGGCCGACGGAAACAGCGTGACCCAGGGAGTGGACACCACCCAGCCAAGCAAGCAGTCCAACAAC
